,AccountsPayableCurrent,AccountsReceivableNetCurrent,AccrualForEnvironmentalLossContingencies,AccrualForEnvironmentalLossContingenciesChargesToExpenseForNewLosses,AccrualForEnvironmentalLossContingenciesPayments,AccrualForEnvironmentalLossContingenciesPayments1,AccrualForEnvironmentalLossContingenciesProvisionForNewLosses,AccrualForTaxesOtherThanIncomeTaxesCurrent,AccruedIncomeTaxes,AccruedIncomeTaxesCurrent,AccruedLiabilitiesCurrent,AccruedVacationCurrent,AccumulatedDepreciationDepletionAndAmortizationPropertyPlantAndEquipment,AccumulatedOtherComprehensiveIncomeLossAvailableForSaleSecuritiesAdjustmentNetOfTax,AccumulatedOtherComprehensiveIncomeLossForeignCurrencyTranslationAdjustmentNetOfTax,AccumulatedOtherComprehensiveIncomeLossNetOfTax,AdditionalPaidInCapital,AdditionalPaidInCapitalCommonStock,AdjustmentsToAdditionalPaidInCapitalSharebasedCompensationRequisiteServicePeriodRecognitionValue,AllowanceForDoubtfulAccountsReceivableCurrent,AreaOfLand,AssetImpairmentCharges,AssetRetirementObligation,AssetRetirementObligationCashPaidToSettle,AssetRetirementObligationLiabilitiesIncurred,Assets,AssetsCurrent,AssetsHeldForSaleNotPartOfDisposalGroupCurrent,AssetsOfDisposalGroupIncludingDiscontinuedOperation,AssetsOfDisposalGroupIncludingDiscontinuedOperationCurrent,AssetsOfDisposalGroupIncludingDiscontinuedOperationNoncurrent,BankOverdrafts,BuildingsAndImprovementsGross,BusinessAcquisitionPercentageOfVotingInterestsAcquired,BusinessAcquisitionProFormaEarningsPerShareBasic,BusinessAcquisitionProFormaEarningsPerShareDiluted,BusinessAcquisitionProFormaIncomeLossFromContinuingOperationsBeforeChangesInAccountingAndExtraordinaryItemsNetOfTaxPerShareBasic,BusinessAcquisitionProFormaIncomeLossFromContinuingOperationsBeforeChangesInAccountingAndExtraordinaryItemsNetOfTaxPerShareDiluted,BusinessAcquisitionPurchasePriceAllocationAssetsAcquired,BusinessAcquisitionPurchasePriceAllocationAssetsAcquiredLiabilitiesAssumedNet,BusinessAcquisitionPurchasePriceAllocationCurrentAssets,BusinessAcquisitionPurchasePriceAllocationCurrentLiabilities,BusinessAcquisitionPurchasePriceAllocationLiabilitiesAssumed,BusinessAcquisitionPurchasePriceAllocationNotesPayableAndLongTermDebt,BusinessAcquisitionPurchasePriceAllocationOtherNoncurrentAssets,BusinessAcquisitionPurchasePriceAllocationOtherNoncurrentLiabilities,BusinessAcquisitionPurchasePriceAllocationPropertyPlantAndEquipment,BusinessAcquisitionsProFormaIncomeLossFromContinuingOperationsBeforeChangesInAccountingAndExtraordinaryItemsNetOfTax,BusinessAcquisitionsProFormaNetIncomeLoss,BusinessAcquisitionsProFormaRevenue,BusinessCombinationConsiderationTransferred1,BusinessCombinationConsiderationTransferredEquityInterestsIssuedAndIssuable,BusinessCombinationRecognizedIdentifiableAssetsAcquiredAndLiabilitiesAssumedAssets,BusinessCombinationRecognizedIdentifiableAssetsAcquiredAndLiabilitiesAssumedCurrentAssets,BusinessCombinationRecognizedIdentifiableAssetsAcquiredAndLiabilitiesAssumedCurrentLiabilities,BusinessCombinationRecognizedIdentifiableAssetsAcquiredAndLiabilitiesAssumedLiabilities,BusinessCombinationRecognizedIdentifiableAssetsAcquiredAndLiabilitiesAssumedNet,BusinessCombinationRecognizedIdentifiableAssetsAcquiredAndLiabilitiesAssumedNoncurrentLiabilitiesLongTermDebt,BusinessCombinationRecognizedIdentifiableAssetsAcquiredAndLiabilitiesAssumedNoncurrentLiabilitiesOther,BusinessCombinationRecognizedIdentifiableAssetsAcquiredAndLiabilitiesAssumedOtherNoncurrentAssets,BusinessCombinationRecognizedIdentifiableAssetsAcquiredAndLiabilitiesAssumedPropertyPlantAndEquipment,CashAcquiredFromAcquisition,CashAndCashEquivalentsAtCarryingValue,CashAndCashEquivalentsAtCarryingValueIncludingDiscontinuedOperations,CashAndCashEquivalentsPeriodIncreaseDecrease,CashCashEquivalentsRestrictedCashAndRestrictedCashEquivalents,CashCashEquivalentsRestrictedCashAndRestrictedCashEquivalentsPeriodIncreaseDecreaseIncludingExchangeRateEffect,CashPaidForCapitalizedInterest,CashProvidedByUsedInInvestingActivitiesDiscontinuedOperations,CashProvidedByUsedInOperatingActivitiesDiscontinuedOperations,CommonStockDividendsPerShareCashPaid,CommonStockParOrStatedValuePerShare,CommonStockSharesAuthorized,CommonStockSharesIssued,CommonStockSharesOutstanding,CommonStocksIncludingAdditionalPaidInCapital,CommonStockValue,CommonStockValueOutstanding,CompensatingBalanceAmount,ComprehensiveIncomeNetOfTax,ComprehensiveIncomeNetOfTaxAttributableToNoncontrollingInterest,ComprehensiveIncomeNetOfTaxIncludingPortionAttributableToNoncontrollingInterest,ConcentrationRiskPercentage1,ConstructionInProgressGross,ConstructionPayableCurrent,ConversionOfStockSharesIssued1,CostOfGoodsAndServicesSold,CostOfGoodsSold,CostsAndExpenses,CurrentFederalTaxExpenseBenefit,CurrentForeignTaxExpenseBenefit,CurrentIncomeTaxExpenseBenefit,CurrentStateAndLocalTaxExpenseBenefit,CustomerRefundLiabilityCurrent,DebtInstrumentCarryingAmount,DebtInstrumentInterestRateDuringPeriod,DebtInstrumentUnamortizedDiscountPremiumAndDebtIssuanceCostsNet,DebtInstrumentUnamortizedDiscountPremiumNet,DebtLongtermAndShorttermCombinedAmount,DeferredCompensationArrangementWithIndividualCommonStockReservedForFutureIssuance,DeferredCompensationArrangementWithIndividualSharesAuthorizedForIssuance,DeferredCompensationArrangementWithIndividualSharesIssued,DeferredFederalIncomeTaxExpenseBenefit,DeferredForeignIncomeTaxExpenseBenefit,DeferredIncomeTaxAssetsNet,DeferredIncomeTaxExpenseBenefit,DeferredIncomeTaxLiabilities,DeferredIncomeTaxLiabilitiesNet,DeferredRevenueCurrent,DeferredStateAndLocalIncomeTaxExpenseBenefit,DeferredTaxAssetsGross,DeferredTaxAssetsLiabilitiesNet,DeferredTaxAssetsNet,DeferredTaxAssetsNetCurrent,DeferredTaxAssetsNetNoncurrent,DeferredTaxAssetsOperatingLossCarryforwards,DeferredTaxAssetsOther,DeferredTaxAssetsTaxCreditCarryforwards,DeferredTaxAssetsTaxCreditCarryforwardsOther,DeferredTaxAssetsTaxDeferredExpenseCompensationAndBenefitsCompensatedAbsences,DeferredTaxAssetsTaxDeferredExpenseCompensationAndBenefitsOther,DeferredTaxAssetsTaxDeferredExpenseCompensationAndBenefitsPensions,DeferredTaxAssetsTaxDeferredExpenseCompensationAndBenefitsPostretirementBenefits,DeferredTaxAssetsTaxDeferredExpenseReservesAndAccrualsImpairmentLosses,DeferredTaxAssetsTaxDeferredExpenseReservesAndAccrualsReserves,DeferredTaxAssetsValuationAllowance,DeferredTaxLiabilities,DeferredTaxLiabilitiesNoncurrent,DeferredTaxLiabilitiesOther,DeferredTaxLiabilitiesOtherFiniteLivedAssets,DeferredTaxLiabilitiesPropertyPlantAndEquipment,DefinedBenefitPlanAccumulatedBenefitObligation,DefinedBenefitPlanAccumulatedOtherComprehensiveIncomeNetGainsLossesAfterTax,DefinedBenefitPlanAccumulatedOtherComprehensiveIncomeNetPriorServiceCostCreditAfterTax,DefinedBenefitPlanActualReturnOnPlanAssets,DefinedBenefitPlanActuarialGainLoss,DefinedBenefitPlanActuarialNetGainsLosses,DefinedBenefitPlanAmortizationOfNetGainsLosses,DefinedBenefitPlanAmortizationOfNetPriorServiceCostCredit,DefinedBenefitPlanAmortizationOfPriorServiceCostCredit,DefinedBenefitPlanAmountsThatWillBeAmortizedFromAccumulatedOtherComprehensiveIncomeLossInNextFiscalYear,DefinedBenefitPlanAmountToBeAmortizedFromAccumulatedOtherComprehensiveIncomeLossNextFiscalYear,DefinedBenefitPlanAssumptionsUsedCalculatingBenefitObligationDiscountRate,DefinedBenefitPlanAssumptionsUsedCalculatingNetPeriodicBenefitCostDiscountRate,DefinedBenefitPlanBenefitObligation,DefinedBenefitPlanBenefitObligationIncreaseDecreaseForRemeasurementDueToSettlement,DefinedBenefitPlanBenefitObligationPeriodIncreaseDecrease,DefinedBenefitPlanEffectOfOnePercentagePointDecreaseOnAccumulatedPostretirementBenefitObligation,DefinedBenefitPlanEffectOfOnePercentagePointDecreaseOnAccumulatedPostretirementBenefitObligation1,DefinedBenefitPlanEffectOfOnePercentagePointDecreaseOnServiceAndInterestCostComponents,DefinedBenefitPlanEffectOfOnePercentagePointDecreaseOnServiceAndInterestCostComponents1,DefinedBenefitPlanEffectOfOnePercentagePointIncreaseOnAccumulatedPostretirementBenefitObligation,DefinedBenefitPlanEffectOfOnePercentagePointIncreaseOnServiceAndInterestCostComponents,DefinedBenefitPlanExpectedAmortizationNextFiscalYear,DefinedBenefitPlanExpectedAmortizationOfGainLossNextFiscalYear,DefinedBenefitPlanExpectedAmortizationOfPriorServiceCostCreditNextFiscalYear,DefinedBenefitPlanExpectedFutureEmployerContributionsRemainderOfFiscalYear,DefinedBenefitPlanFairValueOfPlanAssets,DefinedBenefitPlanFairValueOfPlanAssetsPeriodIncreaseDecrease,DefinedBenefitPlanFutureAmortizationOfGainLoss,DefinedBenefitPlanFutureAmortizationOfPriorServiceCostCredit,DefinedBenefitPlanPensionPlansWithAccumulatedBenefitObligationsInExcessOfPlanAssetsAggregateAccumulatedBenefitObligation,DefinedBenefitPlanPensionPlansWithAccumulatedBenefitObligationsInExcessOfPlanAssetsAggregateFairValueOfPlanAssets,DefinedBenefitPlanPensionPlansWithAccumulatedBenefitObligationsInExcessOfPlanAssetsAggregateProjectedBenefitObligation,DefinedBenefitPlanPensionPlanWithProjectedBenefitObligationInExcessOfPlanAssetsPlanAssets,DefinedBenefitPlanPensionPlanWithProjectedBenefitObligationInExcessOfPlanAssetsProjectedBenefitObligation,DefinedBenefitPlanPlanAmendments,DefinedBenefitPlanRecognizedNetGainLossDueToCurtailments,DefinedBenefitPlanRecognizedNetGainLossDueToSettlementsAndCurtailments,DefinedBenefitPlanRecognizedNetGainLossDueToSettlementsAndCurtailments1,DefinedBenefitPlanSpecialTerminationBenefits,DefinedBenefitPlanWeightedAverageAssetAllocations,DefinedContributionPlanCostRecognized,DefinedContributionPlanNumberOfEmployeesCovered,Depreciation,DepreciationDepletionAndAmortization,DerivativeFairValueOfDerivativeNet,DilutedEarningsPerShareProForma,DiscontinuedOperationAmountOfOtherIncomeLossFromDispositionOfDiscontinuedOperationsBeforeIncomeTax,DiscontinuedOperationGainLossFromDisposalOfDiscontinuedOperationBeforeIncomeTax,DiscontinuedOperationGainLossOnDisposalOfDiscontinuedOperationNetOfTax,DiscontinuedOperationIncomeLossFromDiscontinuedOperationBeforeIncomeTax,DiscontinuedOperationIncomeLossFromDiscontinuedOperationDuringPhaseOutPeriodNetOfTax,DiscontinuedOperationIncomeLossFromDiscontinuedOperationNetOfTaxPerBasicAndDilutedShare,DiscontinuedOperationIncomeLossFromDiscontinuedOperationNetOfTaxPerBasicShare,DiscontinuedOperationIncomeLossFromDiscontinuedOperationNetOfTaxPerDilutedShare,DiscontinuedOperationTaxEffectOfDiscontinuedOperation,DiscontinuedOperationTaxEffectOfIncomeLossFromDiscontinuedOperationDuringPhaseOutPeriod,DisposalGroupIncludingDiscontinuedOperationAccountsNotesAndLoansReceivableNet,DisposalGroupIncludingDiscontinuedOperationAccountsPayable,DisposalGroupIncludingDiscontinuedOperationAccountsPayableCurrent,DisposalGroupIncludingDiscontinuedOperationAccruedLiabilities,DisposalGroupIncludingDiscontinuedOperationAccruedLiabilitiesCurrent,DisposalGroupIncludingDiscontinuedOperationAssetsNoncurrent,DisposalGroupIncludingDiscontinuedOperationCashAndCashEquivalents,DisposalGroupIncludingDiscontinuedOperationCostsOfGoodsSold,DisposalGroupIncludingDiscontinuedOperationDeferredTaxAssetCurrent,DisposalGroupIncludingDiscontinuedOperationDeferredTaxAssetsNoncurrent,DisposalGroupIncludingDiscontinuedOperationDeferredTaxLiabilitiesNoncurrent,DisposalGroupIncludingDiscontinuedOperationGeneralAndAdministrativeExpense,DisposalGroupIncludingDiscontinuedOperationGrossProfitLoss,DisposalGroupIncludingDiscontinuedOperationInterestExpense,DisposalGroupIncludingDiscontinuedOperationInventory,DisposalGroupIncludingDiscontinuedOperationInventoryCurrent,DisposalGroupIncludingDiscontinuedOperationOperatingIncomeLoss,DisposalGroupIncludingDiscontinuedOperationOtherAssets,DisposalGroupIncludingDiscontinuedOperationOtherCurrentAssets,DisposalGroupIncludingDiscontinuedOperationOtherNoncurrentAssets,DisposalGroupIncludingDiscontinuedOperationOtherNoncurrentLiabilities,DisposalGroupIncludingDiscontinuedOperationPrepaidAndOtherAssetsCurrent,DisposalGroupIncludingDiscontinuedOperationPropertyPlantAndEquipment,DisposalGroupIncludingDiscontinuedOperationPropertyPlantAndEquipmentNet,DisposalGroupIncludingDiscontinuedOperationPropertyPlantAndEquipmentNoncurrent,DisposalGroupIncludingDiscontinuedOperationRevenue,DisposalGroupNotDiscontinuedOperationGainLossOnDisposal,DividendsPayableCurrentAndNoncurrent,DueToRelatedPartiesNoncurrent,EarlyRepaymentOfSeniorDebt,EarningsPerShareBasic,EarningsPerShareBasicAndDiluted,EarningsPerShareDiluted,EffectiveIncomeTaxRateContinuingOperations221,EffectiveIncomeTaxRateContinuingOperations222,EffectiveIncomeTaxRateReconciliationAtFederalStatutoryIncomeTaxRate223,EffectiveIncomeTaxRateReconciliationAtFederalStatutoryIncomeTaxRate224,EmployeeRelatedLiabilitiesCurrent,EmployeeRelatedLiabilitiesCurrentAndNoncurrent,EmployeeServiceShareBasedCompensationNonvestedAwardsTotalCompensationCostNotYetRecognized,EmployeeServiceShareBasedCompensationTaxBenefitFromExerciseOfStockOptions,EmployeeServiceShareBasedCompensationTaxBenefitRealizedFromExerciseOfStockOptions,EntityWideDisclosureOnGeographicAreasLongLivedAssetsInEntitysCountryOfDomicile,EntityWideDisclosureOnGeographicAreasRevenueFromExternalCustomersAttributedToEntitysCountryOfDomicile,EntityWideInformationRevenueFromExternalCustomerAmount,EnvironmentalCostsRecognizedRecoveryCreditedToExpense,EnvironmentalExitCostsAssetsPreviouslyDisposedLiabilityForRemediation,EnvironmentalExitCostsReasonablyPossibleAdditionalLossesBestEstimate,EnvironmentalExpenseAndLiabilities,EnvironmentalRemediationExpense,EquityMethodInvestmentDividendsOrDistributions,EquityMethodInvestmentOtherThanTemporaryImpairment,EquityMethodInvestmentSummarizedFinancialInformationCurrentAssets,EquityMethodInvestmentSummarizedFinancialInformationCurrentLiabilities,EquityMethodInvestmentSummarizedFinancialInformationNetIncomeLoss,EquityMethodInvestmentSummarizedFinancialInformationNoncurrentAssets,EquityMethodInvestmentSummarizedFinancialInformationNoncurrentLiabilities,EquityMethodInvestmentSummarizedFinancialInformationRevenue,ExcessTaxBenefitFromShareBasedCompensationFinancingActivities,FederalIncomeTaxExpenseBenefitContinuingOperations,FinanceLeaseInterestExpense,FinanceLeaseLiability,FinanceLeaseLiabilityCurrent,FinanceLeaseLiabilityNoncurrent,FinanceLeaseLiabilityPaymentsDue,FinanceLeaseLiabilityPaymentsDueAfterYearFive,FinanceLeaseLiabilityPaymentsDueNextTwelveMonths,FinanceLeaseLiabilityPaymentsDueYearFive,FinanceLeaseLiabilityPaymentsDueYearFour,FinanceLeaseLiabilityPaymentsDueYearThree,FinanceLeaseLiabilityPaymentsDueYearTwo,FinanceLeaseLiabilityPaymentsRemainderOfFiscalYear,FinanceLeaseLiabilityUndiscountedExcessAmount,FinanceLeasePrincipalPayments,FinanceLeaseRightOfUseAsset,FinanceLeaseWeightedAverageDiscountRatePercent,ForeignCurrencyTransactionGainLossBeforeTax,ForeignCurrencyTransactionGainLossUnrealized,ForeignIncomeTaxExpenseBenefitContinuingOperations,GainLossOnDispositionOfAssets,GainLossOnDispositionOfAssets1,GainLossOnSaleOfBusiness,GainLossOnSaleOfProperty,GainLossOnSaleOfPropertyPlantEquipment,GainLossOnSaleOfTimberProperty,GainLossRelatedToLitigationSettlement,GainsLossesOnExtinguishmentOfDebt,GeneralAndAdministrativeExpense,Goodwill,GoodwillImpairmentLoss,GrossProfit,ImpairmentOfInvestments,ImpairmentOfLongLivedAssetsHeldForUse,ImpairmentOfLongLivedAssetsToBeDisposedOf,ImpairmentOfRealEstate,IncomeLossFromContinuingOperationsBeforeIncomeTaxesDomestic,IncomeLossFromContinuingOperationsBeforeIncomeTaxesExtraordinaryItemsNoncontrollingInterest,IncomeLossFromContinuingOperationsBeforeIncomeTaxesForeign,IncomeLossFromContinuingOperationsBeforeInterestExpenseInterestIncomeIncomeTaxesExtraordinaryItemsNoncontrollingInterestsNet,IncomeLossFromContinuingOperationsIncludingPortionAttributableToNoncontrollingInterest,IncomeLossFromContinuingOperationsPerBasicAndDilutedShare,IncomeLossFromContinuingOperationsPerBasicShare,IncomeLossFromContinuingOperationsPerDilutedShare,IncomeLossFromDiscontinuedOperationsNetOfTax,IncomeLossFromDiscontinuedOperationsNetOfTaxAttributableToReportingEntity,IncomeLossFromDiscontinuedOperationsNetOfTaxPerBasicAndDilutedShare,IncomeLossFromDiscontinuedOperationsNetOfTaxPerBasicShare,IncomeLossFromDiscontinuedOperationsNetOfTaxPerDilutedShare,IncomeLossFromEquityMethodInvestments,IncomeTaxExaminationPenaltiesAndInterestAccrued,IncomeTaxExpenseBenefit,IncomeTaxExpenseBenefitContinuingOperations,IncomeTaxExpenseBenefitContinuingOperationsDiscontinuedOperationsExtraordinaryItems,IncomeTaxesPaid,IncomeTaxesPaidNet,IncomeTaxesReceivable,IncomeTaxReconciliationDeductionsMedicarePrescriptionDrugBenefitSubsidy,IncomeTaxReconciliationDeductionsQualifiedProductionActivities,IncomeTaxReconciliationForeignIncomeTaxRateDifferential,IncomeTaxReconciliationIncomeTaxExpenseBenefitAtFederalStatutoryIncomeTaxRate,IncomeTaxReconciliationOtherAdjustments,IncomeTaxReconciliationOtherReconcilingItems,IncomeTaxReconciliationRepatriationOfForeignEarnings,IncomeTaxReconciliationStateAndLocalIncomeTaxes,IncomeTaxReconciliationTaxContingencies,IncomeTaxReconciliationTaxCredits,IncomeTaxReconciliationTaxCreditsOther,IncomeTaxReconciliationTaxExemptIncome,IncomeTaxReconciliationTaxSettlements,IncomeTaxReconciliationTaxSettlementsStateAndLocal,IncreaseDecreaseInAccountsPayableAndAccruedLiabilities,IncreaseDecreaseInAccountsReceivable,IncreaseDecreaseInDepositOtherAssets,IncreaseDecreaseInIncomeTaxes,IncreaseDecreaseInIncomeTaxesReceivable,IncreaseDecreaseInInventories,IncreaseDecreaseInOtherOperatingCapitalNet,IncreaseDecreaseInOutstandingChecksFinancingActivities,IncreaseDecreaseInPensionPlanObligations,IncreaseDecreaseInPostretirementObligations,IncreaseDecreaseInPrepaidDeferredExpenseAndOtherAssets,IncreaseDecreaseInPrepaidExpense,IncreaseDecreaseInReceivables,IncreaseDecreaseInRestrictedCashAndInvestments,IncrementalCommonSharesAttributableToShareBasedPaymentArrangements,InsuranceRecoveries,InterestAndOtherIncome,InterestCostsCapitalized,InterestExpense,InterestPaidCapitalized,InterestPaidNet,InterestPayableCurrent,InventoryGross,InventoryLIFOReserve,InventoryNet,InventoryOperativeBuilders,InventoryOperativeBuildersOther,InventoryRawMaterialsAndSupplies,InventoryRealEstateLandAndLandDevelopmentCosts,InvestmentsInAffiliatesSubsidiariesAssociatesAndJointVentures,InvestmentsInAffiliatesSubsidiariesAssociatesAndJointVenturesFairValueDisclosure,InvestmentsInAndAdvancesToAffiliatesAtFairValue,Land,LandAvailableForDevelopment,LeaseCost,LesseeOperatingLeaseLiabilityPaymentsDue,LesseeOperatingLeaseLiabilityPaymentsDueAfterYearFive,LesseeOperatingLeaseLiabilityPaymentsDueNextTwelveMonths,LesseeOperatingLeaseLiabilityPaymentsDueYearFive,LesseeOperatingLeaseLiabilityPaymentsDueYearFour,LesseeOperatingLeaseLiabilityPaymentsDueYearThree,LesseeOperatingLeaseLiabilityPaymentsDueYearTwo,LesseeOperatingLeaseLiabilityPaymentsRemainderOfFiscalYear,LesseeOperatingLeaseLiabilityUndiscountedExcessAmount,LettersOfCreditOutstandingAmount,LIFOInventoryAmount,Liabilities,LiabilitiesAndStockholdersEquity,LiabilitiesCurrent,LiabilitiesOfDisposalGroupIncludingDiscontinuedOperation,LiabilitiesOfDisposalGroupIncludingDiscontinuedOperationCurrent,LiabilitiesOfDisposalGroupIncludingDiscontinuedOperationNoncurrent,LineOfCredit,LineOfCreditFacilityAmountOutstanding,LineOfCreditFacilityMaximumBorrowingCapacity,LineOfCreditFacilityRemainingBorrowingCapacity,LinesOfCreditCurrent,LitigationReserve,LitigationReserveCurrent,LongTermDebt,LongTermDebtCurrent,LongTermDebtFairValue,LongTermDebtMaturitiesRepaymentsOfPrincipalAfterYearFive,LongTermDebtMaturitiesRepaymentsOfPrincipalInNextTwelveMonths,LongTermDebtMaturitiesRepaymentsOfPrincipalInYearFive,LongTermDebtMaturitiesRepaymentsOfPrincipalInYearFour,LongTermDebtMaturitiesRepaymentsOfPrincipalInYearThree,LongTermDebtMaturitiesRepaymentsOfPrincipalInYearTwo,LongTermDebtNoncurrent,LossContingencyAccrualAtCarryingValue,LossContingencyAccrualCarryingValueCurrent,LossContingencyAccrualPayments,LossContingencyLossInPeriod,LossContingencyPendingClaimsNumber,LossFromCatastrophes,MachineryAndEquipmentGross,MinorityInterest,MultiemployerPlanPeriodContributions,NetCashProvidedByUsedInFinancingActivities,NetCashProvidedByUsedInInvestingActivities,NetCashProvidedByUsedInOperatingActivities,NetIncomeLoss,NetIncomeLossAttributableToNoncontrollingInterest,NetIncomeLossAvailableToCommonStockholdersBasic,NewAccountingPronouncementOrChangeInAccountingPrincipleCumulativeEffectOfChangeOnEquityOrNetAssets1,NoncashOrPartNoncashAcquisitionDebtAssumed1,NoncashOrPartNoncashDivestitureAmountOfConsiderationReceived1,NoncurrentAssets,NonoperatingIncomeExpense,NonRecourseDebt,NotesAndLoansPayable,NotesPayableCurrent,OperatingIncomeLoss,OperatingLeaseCost,OperatingLeaseLiability,OperatingLeaseLiabilityCurrent,OperatingLeaseLiabilityNoncurrent,OperatingLeasePayments,OperatingLeaseRightOfUseAsset,OperatingLeasesFutureMinimumPaymentsDueCurrent,OperatingLeasesFutureMinimumPaymentsDueInFiveYears,OperatingLeasesFutureMinimumPaymentsDueInFourYears,OperatingLeasesFutureMinimumPaymentsDueInThreeYears,OperatingLeasesFutureMinimumPaymentsDueInTwoYears,OperatingLeasesFutureMinimumPaymentsDueThereafter,OperatingLeasesIncomeStatementSubleaseRevenue,OperatingLeasesRentExpenseMinimumRentals,OperatingLeasesRentExpenseNet,OperatingLeasesRentExpenseSubleaseRentals1,OperatingLeaseWeightedAverageDiscountRatePercent,OriginationOfNotesReceivableFromRelatedParties,OtherAccruedLiabilitiesCurrent,OtherAssetImpairmentCharges,OtherAssets,OtherAssetsCurrent,OtherAssetsMiscellaneousNoncurrent,OtherAssetsNoncurrent,OtherComprehensiveIncomeAvailableForSaleSecuritiesAdjustmentNetOfTaxPeriodIncreaseDecrease,OtherComprehensiveIncomeDefinedBenefitPlanNetPriorServiceCostsCreditArisingDuringPeriodNetOfTax,OtherComprehensiveIncomeDefinedBenefitPlansAdjustmentNetOfTaxPeriodIncreaseDecrease,OtherComprehensiveIncomeDefinedBenefitPlansNetUnamortizedGainLossArisingDuringPeriodNetOfTax,OtherComprehensiveIncomeDefinedBenefitPlansNetUnamortizedGainLossArisingDuringPeriodTax,OtherComprehensiveIncomeDefinedBenefitPlansTax,OtherComprehensiveIncomeForeignCurrencyTransactionAndTranslationAdjustmentBeforeTaxPeriodIncreaseDecrease,OtherComprehensiveIncomeForeignCurrencyTransactionAndTranslationAdjustmentNetOfTaxPeriodIncreaseDecrease,OtherComprehensiveIncomeForeignCurrencyTransactionAndTranslationGainLossArisingDuringPeriodNetOfTax,OtherComprehensiveIncomeForeignCurrencyTranslationGainLossArisingDuringPeriodTax,OtherComprehensiveIncomeLossAvailableForSaleSecuritiesAdjustmentNetOfTax,OtherComprehensiveIncomeLossBeforeReclassificationsBeforeTax,OtherComprehensiveIncomeLossBeforeReclassificationsNetOfTax,OtherComprehensiveIncomeLossBeforeReclassificationsTax,OtherComprehensiveIncomeLossForeignCurrencyTransactionAndTranslationAdjustmentNetOfTax,OtherComprehensiveIncomeLossNetOfTax,OtherComprehensiveIncomeLossNetOfTaxPeriodIncreaseDecrease,OtherComprehensiveIncomeLossNetOfTaxPortionAttributableToParent,OtherComprehensiveIncomeLossPensionAndOtherPostretirementBenefitPlansBenefitPlanImprovementTaxEffect,OtherComprehensiveIncomeReclassificationAdjustmentOnDerivativesIncludedInNetIncomeNetOfTax,OtherComprehensiveIncomeReclassificationAdjustmentOnDerivativesIncludedInNetIncomeTax,OtherComprehensiveIncomeReclassificationOfDefinedBenefitPlansNetGainLossRecognizedInNetPeriodicBenefitCostNetOfTax,OtherComprehensiveIncomeUnrealizedHoldingGainLossOnSecuritiesArisingDuringPeriodNetOfTax,OtherCostAndExpenseOperating,OtherIncomeTaxExpenseBenefitContinuingOperations,OtherInventory,OtherLiabilities,OtherLiabilitiesCurrent,OtherLiabilitiesNoncurrent,OtherLongTermDebt,OtherLongTermDebtCurrent,OtherNonoperatingIncomeExpense,OtherOperatingIncome,OtherOperatingIncomeExpenseNet,OtherRestructuringCosts,OtherSundryLiabilitiesNoncurrent,PaymentsForCapitalImprovements,PaymentsForProceedsFromOtherInvestingActivities,PaymentsForRepurchaseOfCommonStock,PaymentsForRestructuring,PaymentsOfDebtIssuanceCosts,PaymentsOfDistributionsToAffiliates,PaymentsOfDividends,PaymentsOfDividendsCommonStock,PaymentsOfDividendsPreferredStockAndPreferenceStock,PaymentsRelatedToTaxWithholdingForShareBasedCompensation,PaymentsToAcquireBusinessesNetOfCashAcquired,PaymentsToAcquirePropertyPlantAndEquipment,PaymentsToAcquireRealEstate,PaymentsToAcquireShortTermInvestments,PaymentsToAcquireTimberlands,PensionAndOtherPostretirementAndPostemploymentBenefitPlansLiabilitiesNoncurrent,PensionAndOtherPostretirementBenefitContributions,PensionAndOtherPostretirementBenefitExpense,PensionAndOtherPostretirementDefinedBenefitPlansCurrentLiabilities,PensionContributions,PreferredStockDividendsIncomeStatementImpact,PreferredStockIncludingAdditionalPaidInCapital,PreferredStockParOrStatedValuePerShare,PreferredStockSharesAuthorized,PreferredStockValueOutstanding,PrepaidExpenseCurrent,ProceedsFromCollectionOfLongtermLoansToRelatedParties,ProceedsFromCollectionOfNotesReceivable,ProceedsFromContributionsFromAffiliates,ProceedsFromDebtNetOfIssuanceCosts,ProceedsFromDivestitureOfBusinesses,ProceedsFromDivestitureOfBusinessesAndInterestsInAffiliates,ProceedsFromDivestitureOfBusinessesNetOfCashDivested,ProceedsFromEquityMethodInvestmentDividendsOrDistributionsReturnOfCapital,ProceedsFromIssuanceOfCommonStock,ProceedsFromIssuanceOfConvertiblePreferredStock,ProceedsFromIssuanceOfLongTermDebt,ProceedsFromIssuanceOfUnsecuredDebt,ProceedsFromLinesOfCredit,ProceedsFromPartnershipContribution,ProceedsFromPaymentsForOtherFinancingActivities,ProceedsFromRelatedPartyDebt,ProceedsFromRepaymentsOfRestrictedCashFinancingActivities,ProceedsFromRepaymentsOfShortTermDebt,ProceedsFromSaleOfInterestInPartnershipUnit,ProceedsFromSaleOfProductiveAssets,ProceedsFromSaleOfPropertyPlantAndEquipment,ProceedsFromSaleOfShortTermInvestments,ProceedsFromStockOptionsExercised,ProFormaWeightedAverageSharesOutstandingDiluted,ProfitLoss,PropertyPlantAndEquipmentAdditions,PropertyPlantAndEquipmentGross,PropertyPlantAndEquipmentNet,PropertyPlantAndEquipmentOther,PurchaseOptionsLand,RealEstateHeldForDevelopmentAndSale,ReceivablesNetCurrent,ReclassificationFromAccumulatedOtherComprehensiveIncomeCurrentPeriodBeforeTax,ReclassificationFromAccumulatedOtherComprehensiveIncomeCurrentPeriodNetOfTax,ReclassificationFromAociCurrentPeriodTax,RecordedUnconditionalPurchaseObligationDueAfterFifthYear,RecordedUnconditionalPurchaseObligationDueInFifthYear,RecordedUnconditionalPurchaseObligationDueInFourthYear,RecordedUnconditionalPurchaseObligationDueInSecondYear,RecordedUnconditionalPurchaseObligationDueInThirdYear,RecordedUnconditionalPurchaseObligationDueWithinOneYear,RepaymentsOfLinesOfCredit,RepaymentsOfLongTermDebt,RepaymentsOfOtherLongTermDebt,RepaymentsOfRelatedPartyDebt,ResearchAndDevelopmentExpense,RestrictedCashAndCashEquivalentsNoncurrent,RestrictedInvestmentsCurrent,RestrictedInvestmentsNoncurrent,RestrictedStockSharesIssuedNetOfSharesForTaxWithholdings,RestructuringAndRelatedCostExpectedCostRemaining,RestructuringCharges,RestructuringReserve,RestructuringReserveAccrualAdjustment,RestructuringReservePeriodExpense,RestructuringReserveSettledWithCash,RestructuringSettlementAndImpairmentProvisions,RetainedEarningsAccumulatedDeficit,Revenues,RevenuesFromExternalCustomers,RevenuesFromTransactionsWithOtherOperatingSegmentsOfSameEntity,RightOfUseAssetObtainedInExchangeForFinanceLeaseLiability,RightOfUseAssetObtainedInExchangeForOperatingLeaseLiability,SalesRevenueNet,SegmentReportingInformationEquityInNetIncomeOfEquityMethodInvesteesOfSegment,SegmentReportingInformationIntersegmentRevenue,SegmentReportingInformationRevenue,SegmentReportingInformationRevenueFromExternalCustomers,SellingExpense,SellingGeneralAndAdministrativeExpense,SeveranceCosts,SeveranceCosts1,ShareBasedCompensation,ShareBasedCompensationArrangementByShareBasedPaymentAwardFairValueAssumptionsExpectedVolatilityRateMaximum,ShareBasedCompensationArrangementByShareBasedPaymentAwardFairValueAssumptionsExpectedVolatilityRateMinimum,ShareBasedCompensationArrangementByShareBasedPaymentAwardFairValueAssumptionsRiskFreeInterestRateMaximum,ShareBasedCompensationArrangementByShareBasedPaymentAwardFairValueAssumptionsRiskFreeInterestRateMinimum,ShareBasedCompensationArrangementByShareBasedPaymentAwardNumberOfSharesAuthorized,ShareBasedCompensationArrangementByShareBasedPaymentAwardNumberOfSharesAvailableForGrant,ShareBasedCompensationArrangementByShareBasedPaymentAwardOptionsExercisableNumber,ShareBasedCompensationArrangementByShareBasedPaymentAwardOptionsExercisableWeightedAverageExercisePrice,ShareBasedCompensationArrangementByShareBasedPaymentAwardOptionsExercisableWeightedAverageRemainingContractualTerm,ShareBasedCompensationArrangementByShareBasedPaymentAwardOptionsExercisesInPeriodTotalIntrinsicValue,ShareBasedCompensationArrangementByShareBasedPaymentAwardOptionsExercisesInPeriodWeightedAverageExercisePrice,ShareBasedCompensationArrangementByShareBasedPaymentAwardOptionsForfeituresAndExpirationsInPeriod,ShareBasedCompensationArrangementByShareBasedPaymentAwardOptionsForfeituresAndExpirationsInPeriodWeightedAverageExercisePrice,ShareBasedCompensationArrangementByShareBasedPaymentAwardOptionsGrantsInPeriod,ShareBasedCompensationArrangementByShareBasedPaymentAwardOptionsGrantsInPeriodWeightedAverageExercisePrice,ShareBasedCompensationArrangementByShareBasedPaymentAwardOptionsOutstandingIntrinsicValue,ShareBasedCompensationArrangementByShareBasedPaymentAwardOptionsOutstandingNumber,ShareBasedCompensationArrangementByShareBasedPaymentAwardOptionsOutstandingWeightedAverageExercisePrice,ShareBasedCompensationArrangementByShareBasedPaymentAwardSharesIssuedInPeriod,ShareBasedCompensationArrangementsByShareBasedPaymentAwardOptionsExercisesInPeriodWeightedAverageExercisePrice,ShareBasedCompensationArrangementsByShareBasedPaymentAwardOptionsGrantsInPeriodWeightedAverageExercisePrice,SharebasedCompensationArrangementBySharebasedPaymentAwardOptionsExercisableIntrinsicValue1,SharebasedCompensationArrangementBySharebasedPaymentAwardOptionsOutstandingWeightedAverageRemainingContractualTerm1,SharebasedCompensationArrangementBySharebasedPaymentAwardOptionsVestedInPeriodFairValue1,SharePrice,SignificantChangeInUnrecognizedTaxBenefitsIsReasonablyPossibleAmountOfUnrecordedBenefit,SiteContingencyLossExposureInExcessOfAccrualBestEstimate,StateAndLocalIncomeTaxExpenseBenefitContinuingOperations,StockholdersEquity,StockholdersEquityIncludingPortionAttributableToNoncontrollingInterest,StockIssuedDuringPeriodSharesNewIssues,StockIssuedDuringPeriodSharesOther,StockIssuedDuringPeriodSharesShareBasedCompensation,StockIssuedDuringPeriodSharesStockOptionsExercised,StockRedeemedOrCalledDuringPeriodShares,StockRepurchasedAndRetiredDuringPeriodShares,StockRepurchasedAndRetiredDuringPeriodValue,StockRepurchasedDuringPeriodShares,StockRepurchasedDuringPeriodValue,StockRepurchaseProgramAuthorizedAmount1,StockRepurchaseProgramRemainingAuthorizedRepurchaseAmount1,TaxAdjustmentsSettlementsAndUnusualProvisions,TimberAndTimberlands,UnamortizedDebtIssuanceExpense,UndistributedEarningsOfForeignSubsidiaries,UnrecognizedTaxBenefits,UnrecognizedTaxBenefitsDecreasesResultingFromPriorPeriodTaxPositions,UnrecognizedTaxBenefitsDecreasesResultingFromSettlementsWithTaxingAuthorities,UnrecognizedTaxBenefitsIncomeTaxPenaltiesAndInterestAccrued,UnrecognizedTaxBenefitsIncreasesResultingFromCurrentPeriodTaxPositions,UnrecognizedTaxBenefitsIncreasesResultingFromPriorPeriodTaxPositions,UnrecognizedTaxBenefitsInterestOnIncomeTaxesAccrued,UnrecognizedTaxBenefitsReductionsResultingFromLapseOfApplicableStatuteOfLimitations,UnrecognizedTaxBenefitsThatWouldImpactEffectiveTaxRate,UnrecordedUnconditionalPurchaseObligationBalanceOnFifthAnniversary,UnrecordedUnconditionalPurchaseObligationBalanceOnFirstAnniversary,UnrecordedUnconditionalPurchaseObligationBalanceOnFourthAnniversary,UnrecordedUnconditionalPurchaseObligationBalanceOnSecondAnniversary,UnrecordedUnconditionalPurchaseObligationBalanceOnThirdAnniversary,UnrecordedUnconditionalPurchaseObligationDueAfterFiveYears,ValuationAllowanceDeferredTaxAssetChangeInAmount,ValuationAllowancesAndReservesPeriodIncreaseDecrease,VariableInterestEntityConsolidatedLiabilitiesCurrentNoRecourse,WeightedAverageNumberOfDilutedSharesOutstanding,WeightedAverageNumberOfSharesOutstandingBasic,DeferredTaxAssetsPropertyPlantAndEquipment,DebtInstrumentFaceAmount,ExtinguishmentOfDebtGainLossNetOfTax,RepaymentsOfDebt,RestrictedCashAndCashEquivalentsAtCarryingValue,DebtInstrumentFairValue,LitigationSettlementAmountAwardedToOtherParty,y
0,373000000,337000000.0,31000000.0,7000000.0,3000000.0,10000000.0,1000000.0,29000000.0,0.0,0.0,662000000,50000000.0,6388000000,3000000.0,389000000.0,-495000000.0,1767000000.0,8172000000.0,15000000.0,7000000.0,82000.0,384000000.0,66000000.0,10000000.0,9000000.0,16735000000.0,2407000000.0,0.0,164000000.0,106000000.0,1694000000.0,45000000.0,1327000000.0,1.0,0.19,0.19,0.48,0.47,2772000000.0,1606000000.0,46000000.0,7000000.0,1166000000.0,1140000000.0,1000000.0,19000000.0,2000000.0,276000000.0,110000000.0,3379000000.0,2650000000.0,0.0,2741000000.0,46000000.0,10000000.0,1137000000.0,1604000000.0,1122000000.0,5000000.0,2000000.0,39000000.0,0.0,243000000.0,953000000.0,-129000000.0,676000000.0,148000000.0,104000000.0,581000000.0,399000000.0,2.4,1.25,400000000.0,211289320.0,209546000.0,638000000.0,264000000.0,264000000.0,40000000.0,-521000000.0,-12000000.0,-533000000.0,0.14,50000000.0,30000000.0,0.0,4980000000.0,7508000000.0,11026000000.0,-475000000.0,-50000000.0,65000000.0,-2000000.0,44000000.0,4296000000.0,0.18,500000000.0,5000000.0,5992000000.0,665774.0,468185.0,40889.0,-290000000.0,-28000000.0,72000000.0,66000000.0,833000000.0,0.0,71000000.0,-57000000.0,1377000000.0,-1130000000.0,1274000000.0,88000000.0,368000000.0,191000000.0,371000000.0,55000000.0,240000000.0,19000000.0,23000000.0,109000000.0,172000000.0,205000000.0,14000000.0,103000000.0,2404000000.0,0.0,253000000.0,1089000000.0,776000000.0,5100000000.0,-1821000000.0,-227000000.0,-1972000000.0,343000000.0,82000000.0,-151000000.0,-7000000.0,-103000000.0,144000000.0,-50000000.0,0.038,0.044,155000000.0,-24000000.0,55000000.0,-12000000.0,10000000.0,-1000000.0,1000000.0,13000000.0,1000000.0,245000000.0,-250000000.0,-5000000.0,40000000.0,4313000000.0,167000000.0,-135000000.0,-185000000.0,2800000000.0,2000000000.0,2900000000.0,4100000000.0,4500000000.0,-52000000.0,5000000.0,116000000.0,-7000000.0,9000000.0,1.0,15000000.0,1300.0,374000000.0,626000000.0,223000000.0,-1.02,1405000000.0,218000000.0,0.0,-68000000.0,219000000.0,0.02,0.03,0.03,-25000000.0,105000000.0,36000000.0,8000000.0,41000000.0,24000000.0,113000000.0,1715000000.0,13000000.0,2030000000.0,21000000.0,136000000.0,336000000.0,57000000.0,479000000.0,1000000.0,63000000.0,243000000.0,320000000.0,15000000.0,7000000.0,96000000.0,27000000.0,11000000.0,15000000.0,43000000.0,1339000000.0,3301000000.0,0.0,0.0,0.0,518000000.0,-5.57,-0.03,-5.57,0.32,0.347,0.35,0.35,160000000.0,223000000.0,41000000.0,8000000.0,9000000.0,5946000000.0,3580000000.0,11401000000.0,0.0,28000000.0,99000000.0,17000000.0,2000000.0,0.0,84000000.0,201000000.0,175000000.0,-1000000.0,817000000.0,176000000.0,615000000.0,0.0,-765000000.0,8000000.0,38000000.0,14000000.0,24000000.0,40000000.0,0.0,14000000.0,3000000.0,5000000.0,8000000.0,12000000.0,12000000.0,-2000000.0,8000000.0,34000000.0,0.029,42000000.0,45000000.0,-78000000.0,-29000000.0,22000000.0,972000000.0,0.0,7000000.0,-163000000.0,2000000.0,-45000000.0,450000000.0,40000000.0,838000000.0,592000000.0,160000000.0,1998000000.0,80000000.0,13000000.0,-605000000.0,-774000000.0,-169000000.0,203000000.0,-299000000.0,-0.05,-8.72,-8.72,1038000000.0,15000000.0,0.02,3.15,3.15,-3000000.0,30000000.0,-179000000.0,-900000000.0,-274000000.0,193000000.0,1174000000.0,95000000.0,-2000000.0,0.0,23000000.0,-271000000.0,9000000.0,0.0,0.0,-24000000.0,-3000000.0,6000000.0,149000000.0,0.0,0.0,0.0,-261000000.0,55000000.0,10000000.0,-50000000.0,200000000.0,53000000.0,72000000.0,-89000000.0,0.0,0.0,12000000.0,-10000000.0,118000000.0,0.0,4194000.0,0.0,74000000.0,-18000000.0,415000000.0,32.0,463000000.0,100000000.0,596000000.0,120000000.0,447000000.0,695000000.0,10000000.0,135000000.0,433000000.0,213000000.0,0.0,232000000.0,129000000.0,971000000.0,4000000.0,159000000.0,76000000.0,20000000.0,15000000.0,17000000.0,16000000.0,20000000.0,15000000.0,-32000000.0,53000000.0,118000000.0,11888000000.0,16735000000.0,1605000000.0,186000000.0,32000000.0,32000000.0,0.0,0.0,400000000.0,1075000000.0,0.0,0.0,5000000.0,4291000000.0,409000000.0,6995000000.0,4553000000.0,0.0,62000000.0,281000000.0,0.0,0.0,3882000000.0,0.0,0.0,61000000.0,0.0,53.0,0.0,6926000000.0,33000000.0,3000000.0,-1580000000.0,816000000.0,635000000.0,790000000.0,-51000000.0,331000000.0,19000000.0,0.0,0.0,7713000000.0,-80000000.0,511000000.0,6344000000.0,0.0,-93000000.0,5000000.0,127000000.0,14000000.0,113000000.0,10000000.0,125000000.0,88000000.0,17000000.0,20000000.0,48000000.0,94000000.0,154000000.0,67000000.0,157000000.0,92000000.0,65000000.0,0.043,0.0,120000000,8000000.0,400000000.0,694000000.0,1369000000.0,403000000.0,0.0,5000000.0,34000000.0,-132000000.0,-2000000.0,43000000.0,32000000.0,20000000.0,32000000.0,4000000.0,0.0,-689000000.0,-427000000.0,-377000000.0,30000000.0,416000000.0,-151000000.0,35000000.0,2000000.0,1000000.0,1000000.0,-175000000.0,1000000.0,-36000000.0,-15000000.0,97000000.0,551000000.0,635000000.0,409000000.0,1000000.0,161000000.0,-52000000.0,27000000.0,288000000.0,21000000.0,1739000000.0,36000000.0,51000000.0,473000000.0,4000000.0,11000000.0,0.0,531000000.0,323000000.0,0.0,21000000.0,0.0,680000000.0,0.0,0.0,0.0,1930000000.0,115000000.0,18000000.0,58000000.0,28000000.0,0.0,14000000.0,1.0,7000000.0,0.0,88000000,146000000.0,0.0,0.0,0.0,707000000.0,0.0,0.0,4000000.0,0.0,0.0,451000000.0,0.0,0.0,0.0,55000000.0,0.0,0.0,302000000.0,0.0,6000000.0,0.0,0.0,321000000.0,535577000.0,739000000.0,443000000.0,9260000000.0,2872000000,329000000.0,34000000.0,598000000.0,523000000.0,-68000000.0,-48000000.0,-16000000.0,12000000.0,12000000.0,15000000.0,25000000.0,16000000.0,60000000.0,0.0,1616000000.0,209000000.0,0.0,66000000.0,0.0,184000000.0,615000000.0,135000.0,10000000.0,127000000.0,22000000.0,7000000.0,23000000.0,25000000.0,686000000.0,3278000000.0,6216000000.0,1419000000.0,191000000.0,4000000.0,5000000.0,10933000000.0,36000000.0,324000000.0,1610000000.0,2666000000.0,200000000.0,996000000.0,104000000.0,4000000.0,41000000.0,0.3574,0.2865,0.008,0.0012,9200000.0,11714621.0,22277000.0,24.1,4.0,28000000.0,17.43,-3961000.0,24.4,1266587.0,24.16,0.0,33379000.0,39.3,2459392.0,20.59,20.42,0.0,4.91,15000000.0,33.22,1000000.0,90000000.0,-57000000.0,4814000000.0,8171000000.0,0.0,0.0,1000.0,68000.0,0.0,31367541.0,863000000.0,66691.0,2000000.0,2500000000.0,1638000000.0,7000000.0,3961000000.0,16000000.0,22000000.0,132000000.0,4000000.0,0.0,23000000.0,53000000.0,17000000.0,22000000.0,5000000.0,96000000.0,2000000.0,105000000.0,2000000.0,7000000.0,5000000.0,9000000.0,4000000.0,17000000.0,0.0,219305000.0,219305000.0,15000000.0,900000000.0,207000000.0,931000000.0,0.0,8000000.0,50000000.0,1
1,384000000,337000000.0,31000000.0,29000000.0,4000000.0,15000000.0,1000000.0,32000000.0,139000000.0,4000000.0,742000000,48000000.0,6368000000,3000000.0,389000000.0,-495000000.0,1767000000.0,8172000000.0,8000000.0,4000000.0,,511000000.0,68000000.0,10000000.0,8000000.0,16735000000.0,2326000000.0,0.0,164000000.0,106000000.0,1827000000.0,47000000.0,1262000000.0,1.0,0.13,0.13,0.84,0.83,,,,,,,,,,346000000.0,74000000.0,1840000000.0,2650000000.0,0.0,,,,,,,,,,0.0,114000000.0,898000000.0,-25000000.0,824000000.0,-476000000.0,32000000.0,-58000000.0,173000000.0,1.2,1.25,400000000.0,211289320.0,211289320.0,638000000.0,264000000.0,264000000.0,50000000.0,-85000000.0,-10000000.0,-95000000.0,0.13,112000000.0,48000000.0,0.0,3982000000.0,5127000000.0,4880000000.0,-350000000.0,12000000.0,-49000000.0,-1000000.0,50000000.0,4896000000.0,0.18,500000000.0,5000000.0,6344000000.0,615604.0,489792.0,40889.0,133000000.0,-45000000.0,72000000.0,34000000.0,746000000.0,43000000.0,82000000.0,-22000000.0,1313000000.0,13000000.0,1193000000.0,130000000.0,5000000.0,140000000.0,334000000.0,57000000.0,240000000.0,18000000.0,20000000.0,337000000.0,134000000.0,141000000.0,38000000.0,120000000.0,1180000000.0,285000000.0,211000000.0,24000000.0,668000000.0,5700000000.0,-1821000000.0,-227000000.0,691000000.0,115000000.0,82000000.0,-185000000.0,-118000000.0,0.0,67000000.0,183000000.0,,,,-24000000.0,55000000.0,-11000000.0,7000000.0,,1000000.0,12000000.0,1000000.0,118000000.0,-115000000.0,3000000.0,40000000.0,4773000000.0,167000000.0,-188000000.0,-5000000.0,1000000000.0,639000000.0,1100000000.0,2800000000.0,3400000000.0,,,7000000.0,-6000000.0,,1.0,12000000.0,1300.0,332000000.0,538000000.0,290000000.0,-0.01,-5000000.0,,0.0,8000000.0,-43000000.0,0.0,0.02,0.02,3000000.0,,36000000.0,8000000.0,,24000000.0,,1694000000.0,5000000.0,809000000.0,21000000.0,115000000.0,336000000.0,16000000.0,105000000.0,9000000.0,63000000.0,243000000.0,378000000.0,15000000.0,7000000.0,,,,,43000000.0,1339000000.0,-3301000000.0,46000000.0,375000000.0,0.0,40000000.0,-1.25,0.07,-1.25,0.325,0.32,,0.35,159000000.0,184000000.0,38000000.0,12000000.0,4000000.0,5682000000.0,3965000000.0,5528000000.0,42000000.0,37000000.0,94000000.0,17000000.0,,0.0,,119000000.0,44000000.0,-7000000.0,468000000.0,141000000.0,553000000.0,0.0,-217000000.0,4000000.0,38000000.0,14000000.0,24000000.0,39000000.0,0.0,11000000.0,3000000.0,6000000.0,9000000.0,13000000.0,8000000.0,1000000.0,11000000.0,33000000.0,0.03,5000000.0,-8000000.0,-33000000.0,-22000000.0,36000000.0,0.0,0.0,17000000.0,163000000.0,-11000000.0,32000000.0,423000000.0,42000000.0,3000000.0,401000000.0,7000000.0,451000000.0,,10000000.0,96000000.0,20000000.0,-14000000.0,368000000.0,-706000000.0,0.04,-2.58,-2.58,198000000.0,13000000.0,0.03,-0.2,-0.2,-3000000.0,33000000.0,-353000000.0,-274000000.0,45000000.0,28000000.0,42000000.0,101000000.0,-26000000.0,0.0,4000000.0,29000000.0,2000000.0,0.0,0.0,4000000.0,-7000000.0,4000000.0,0.0,37000000.0,0.0,0.0,-110000000.0,47000000.0,4000000.0,-103000000.0,229000000.0,-84000000.0,124000000.0,-39000000.0,-16000000.0,0.0,7000000.0,-39000000.0,240000000.0,0.0,3997000.0,0.0,83000000.0,-9000000.0,229000000.0,6000000.0,216000000.0,104000000.0,643000000.0,112000000.0,447000000.0,851000000.0,8000000.0,135000000.0,478000000.0,190000000.0,0.0,214000000.0,129000000.0,613000000.0,18000000.0,161000000.0,81000000.0,19000000.0,16000000.0,17000000.0,17000000.0,20000000.0,10000000.0,32000000.0,39000000.0,159000000.0,11888000000.0,16735000000.0,1128000000.0,,32000000.0,,0.0,0.0,1000000000.0,1270000000.0,0.0,0.0,,4891000000.0,0.0,6995000000.0,4053000000.0,0.0,500000000.0,62000000.0,281000000.0,0.0,4891000000.0,98000000.0,0.0,,0.0,50.0,0.0,6712000000.0,33000000.0,4000000.0,403000000.0,-336000000.0,-92000000.0,-244000000.0,-64000000.0,41000000.0,,0.0,0.0,7415000000.0,-149000000.0,511000000.0,6377000000.0,2000000.0,-664000000.0,10000000.0,129000000.0,15000000.0,114000000.0,15000000.0,126000000.0,35000000.0,11000000.0,13000000.0,22000000.0,29000000.0,108000000.0,,126000000.0,55000000.0,62000000.0,0.042,0.0,119000000,17000000.0,324000000.0,1162000000.0,1244000000.0,324000000.0,1000000.0,-1000000.0,,253000000.0,235000000.0,,54000000.0,11000000.0,-31000000.0,-2000000.0,,-9000000.0,-14000000.0,10000000.0,22000000.0,19000000.0,21000000.0,129000000.0,3000000.0,1000000.0,0.0,-20000000.0,,-27000000.0,3000000.0,97000000.0,382000000.0,891000000.0,382000000.0,1000000.0,0.0,-8000000.0,26000000.0,70000000.0,4000000.0,1851000000.0,19000000.0,-4000000.0,0.0,9000000.0,11000000.0,0.0,253000000.0,334000000.0,0.0,10000000.0,0.0,215000000.0,0.0,701000000.0,0.0,516000000.0,280000000.0,-74000000.0,57000000.0,8000000.0,0.0,14000000.0,1.0,7000000.0,0.0,128000000,0.0,0.0,0.0,739000000.0,0.0,253000000.0,0.0,0.0,0.0,0.0,0.0,0.0,0.0,0.0,-31000000.0,0.0,0.0,830000000.0,0.0,24000000.0,0.0,0.0,3000000.0,535657000.0,-28000000.0,223000000.0,9072000000.0,2704000000,319000000.0,47000000.0,517000000.0,518000000.0,-165000000.0,-109000000.0,-32000000.0,7000000.0,2000000.0,9000000.0,31000000.0,31000000.0,63000000.0,0.0,107000000.0,,0.0,51000000.0,53000000.0,0.0,615000000.0,165000.0,,247000000.0,20000000.0,,1000000.0,-18000000.0,2000000.0,3278000000.0,7059000000.0,3224000000.0,339000000.0,5000000.0,5000000.0,4216000000.0,3000000.0,132000000.0,3263000000.0,1391000000.0,178000000.0,709000000.0,102000000.0,0.0,33000000.0,,,,,,11848635.0,16787000.0,24.14,,61000000.0,,-2835000.0,24.26,1942000.0,,133000000.0,29169000.0,22.16,2662393.0,22.37,30.48,71000000.0,,14000000.0,,160000000.0,95000000.0,-24000000.0,4814000000.0,4847000000.0,0.0,0.0,133000.0,1000.0,0.0,58040937.0,1695000000.0,66691.0,2000000000.0,2500000000.0,806000000.0,,2654000000.0,13000000.0,23000000.0,170000000.0,6000000.0,-2000000.0,30000000.0,1000000.0,,27000000.0,6000000.0,98000000.0,3000000.0,61000000.0,3000000.0,16000000.0,4000000.0,8000000.0,5000000.0,,209000000.0,211228000.0,211228000.0,15000000.0,900000000.0,207000000.0,931000000.0,8000000.0,4000000.0,,1
2,384000000,368000000.0,31000000.0,27000000.0,6000000.0,13000000.0,4000000.0,32000000.0,139000000.0,4000000.0,742000000,48000000.0,6368000000,3000000.0,389000000.0,-495000000.0,1767000000.0,8140000000.0,15000000.0,4000000.0,645000.0,817000000.0,67000000.0,14000000.0,8000000.0,16695000000.0,2326000000.0,251000000.0,164000000.0,106000000.0,,,1275000000.0,1.0,0.61,0.6,,,,,,,,,,,,198000000.0,214000000.0,5192000000.0,2650000000.0,6383000000.0,,,,,,,,,,0.0,114000000.0,,3988000000.0,824000000.0,-490000000.0,29000000.0,-31000000.0,73000000.0,0.6,1.25,400000000.0,211289320.0,211289320.0,948000000.0,,264000000.0,11000000.0,-415000000.0,-17000000.0,-432000000.0,,112000000.0,48000000.0,,1374000000.0,4661000000.0,2580000000.0,-333000000.0,,,3000000.0,50000000.0,,,500000000.0,,,639000.0,495147.0,40889.0,140000000.0,,72000000.0,90000000.0,390000000.0,43000000.0,82000000.0,,1335000000.0,,,130000000.0,5000000.0,162000000.0,390000000.0,,238000000.0,,,,,,,142000000.0,,285000000.0,235000000.0,,,,-1821000000.0,-227000000.0,515000000.0,,,-234000000.0,-16000000.0,,218000000.0,157000000.0,,0.043,,24000000.0,19000000.0,,12000000.0,,1000000.0,12000000.0,2000000.0,,,,40000000.0,,138000000.0,-161000000.0,-4000000.0,,,,,,,,6000000.0,,,,,1200.0,344000000.0,,,0.03,,,,9000000.0,9000000.0,,0.06,0.06,,,36000000.0,8000000.0,41000000.0,24000000.0,113000000.0,1694000000.0,,417000000.0,,115000000.0,336000000.0,8000000.0,50000000.0,4000000.0,63000000.0,243000000.0,93000000.0,15000000.0,7000000.0,96000000.0,27000000.0,11000000.0,15000000.0,43000000.0,1339000000.0,460000000.0,,,835000000.0,,-1.75,0.18,-1.75,0.321,0.312,,0.35,159000000.0,192000000.0,33000000.0,,,5510000000.0,,6552000000.0,,36000000.0,97000000.0,0.0,12000000.0,0.0,,141000000.0,125000000.0,-3000000.0,723000000.0,,644000000.0,,-193000000.0,12000000.0,36000000.0,14000000.0,22000000.0,37000000.0,0.0,8000000.0,4000000.0,7000000.0,9000000.0,13000000.0,4000000.0,1000000.0,16000000.0,31000000.0,0.031,4000000.0,-21000000.0,,22000000.0,,,,39000000.0,0.0,-10000000.0,,,42000000.0,,407000000.0,,157000000.0,,,,21000000.0,,209000000.0,-205000000.0,0.18,-2.38,-2.38,111000000.0,36000000.0,0.0,0.04,0.04,0.0,,-214000000.0,-1187000000.0,7000000.0,13000000.0,,101000000.0,,,,,,,,,,,0.0,,,,1037000000.0,,9000000.0,,529000000.0,-142000000.0,176000000.0,-99000000.0,655000000.0,0.0,18000000.0,-62000000.0,43000000.0,0.0,3587000.0,0.0,80000000.0,-25000000.0,114000000.0,11.0,391000000.0,104000000.0,,112000000.0,472000000.0,851000000.0,,134000000.0,,190000000.0,0.0,210000000.0,,613000000.0,9000000.0,157000000.0,81000000.0,21000000.0,16000000.0,17000000.0,18000000.0,20000000.0,5000000.0,31000000.0,,172000000.0,11848000000.0,16695000000.0,1128000000.0,186000000.0,32000000.0,32000000.0,0.0,0.0,1000000000.0,1500000000.0,0.0,0.0,,4891000000.0,,6995000000.0,3503000000.0,0.0,550000000.0,500000000.0,62000000.0,281000000.0,4891000000.0,,50000000.0,,,49.0,,6742000000.0,33000000.0,,-1096000000.0,5223000000.0,-139000000.0,-96000000.0,-5000000.0,84000000.0,,0.0,0.0,,-76000000.0,511000000.0,,2000000.0,-406000000.0,5000000.0,126000000.0,20000000.0,106000000.0,20000000.0,123000000.0,35000000.0,11000000.0,15000000.0,18000000.0,27000000.0,108000000.0,,83000000.0,,62000000.0,0.042,,119000000,,403000000.0,1415000000.0,2638000000.0,324000000.0,,0.0,,199000000.0,,,76000000.0,,-16000000.0,,1000000.0,1156000000.0,728000000.0,19000000.0,2000000.0,3000000.0,-45000000.0,94000000.0,,,0.0,-175000000.0,2000000.0,0.0,,86000000.0,409000000.0,,382000000.0,,,-14000000.0,28000000.0,72000000.0,1000000.0,1876000000.0,23000000.0,-13000000.0,0.0,16000000.0,,0.0,380000000.0,,,11000000.0,0.0,295000000.0,36000000.0,701000000.0,0.0,516000000.0,,-137000000.0,57000000.0,62000000.0,,14000000.0,,,0.0,128000000,0.0,,0.0,739000000.0,,,0.0,0.0,0.0,0.0,491000000.0,0.0,0.0,0.0,-41000000.0,0.0,0.0,-381000000.0,,36000000.0,,0.0,4000000.0,535676000.0,275000000.0,234000000.0,9016000000.0,2704000000,332000000.0,,,518000000.0,-219000000.0,-144000000.0,-47000000.0,,,,,,,0.0,199000000.0,,,,,0.0,615000000.0,,,238000000.0,,,4000000.0,20000000.0,6000000.0,3278000000.0,5989000000.0,1805000000.0,148000000.0,5000000.0,6000000.0,2174000000.0,,465000000.0,1789000000.0,4073000000.0,,681000000.0,101000000.0,,46000000.0,,,,,,19902470.0,12441000.0,22.71,,,,515000.0,28.29,1915000.0,,144000000.0,,22.34,2710962.0,22.5,30.14,110000000.0,,,,160000000.0,101000000.0,-23000000.0,4814000000.0,,,,,133000.0,,26673396.0,832000000.0,,0.0,2500000000.0,500000000.0,,2723000000.0,,27000000.0,48000000.0,-6000000.0,,,,91000000.0,,-6000000.0,,2000000.0,35000000.0,6000000.0,16000000.0,6000000.0,7000000.0,-47000000.0,,,211262000.0,211262000.0,,900000000.0,207000000.0,931000000.0,,,,1
3,343000000,309000000.0,29000000.0,4000000.0,7000000.0,5000000.0,12000000.0,32000000.0,139000000.0,4000000.0,629000000,48000000.0,6327000000,3000000.0,387000000.0,-646000000.0,1776000000.0,8152000000.0,8000000.0,4000000.0,645000.0,2164000000.0,59000000.0,10000000.0,10000000.0,,2326000000.0,140000000.0,169000000.0,113000000.0,,15000000.0,1220000000.0,1.0,0.62,0.62,,,,,,,,,,,,478000000.0,104000000.0,1813000000.0,2650000000.0,6383000000.0,,,,,,,,,,9000000.0,114000000.0,898000000.0,2180000000.0,,,,-85000000.0,248000000.0,1.8,1.25,400000000.0,211356803.0,211289320.0,916000000.0,,264000000.0,14000000.0,106000000.0,-5000000.0,101000000.0,,112000000.0,33000000.0,23200000.0,5298000000.0,1232000000.0,7343000000.0,58000000.0,9000000.0,-54000000.0,,50000000.0,4896000000.0,,,5000000.0,,674000.0,,40899.0,-1180000000.0,-8000000.0,65000000.0,-940000000.0,425000000.0,43000000.0,82000000.0,-69000000.0,1447000000.0,228000000.0,1301000000.0,130000000.0,5000000.0,162000000.0,371000000.0,57000000.0,240000000.0,18000000.0,,521000000.0,144000000.0,115000000.0,13000000.0,146000000.0,1073000000.0,285000000.0,186000000.0,,610000000.0,6400000000.0,-1773000000.0,-121000000.0,,,,,,-151000000.0,,223000000.0,,,,,19000000.0,,8000000.0,,1000000.0,8000000.0,1000000.0,,,,,,138000000.0,-227000000.0,-4000000.0,5700000000.0,4700000000.0,5800000000.0,2300000000.0,3100000000.0,,,,0.0,,1.0,19000000.0,1200.0,332000000.0,126000000.0,425000000.0,2.07,13000000.0,,0.0,15000000.0,4000000.0,,0.04,0.04,6000000.0,,42000000.0,8000000.0,41000000.0,25000000.0,113000000.0,0.0,5000000.0,1181000000.0,,115000000.0,359000000.0,21000000.0,204000000.0,3000000.0,63000000.0,230000000.0,43000000.0,16000000.0,8000000.0,96000000.0,27000000.0,11000000.0,,40000000.0,1313000000.0,300000000.0,0.0,,830000000.0,,-0.5,0.2,-0.5,0.423,0.34,,0.21,159000000.0,192000000.0,36000000.0,6000000.0,6000000.0,,4008000000.0,,5000000.0,33000000.0,100000000.0,0.0,11000000.0,5000000.0,,123000000.0,30000000.0,3000000.0,413000000.0,109000000.0,534000000.0,0.0,-1122000000.0,4000000.0,33000000.0,13000000.0,20000000.0,35000000.0,0.0,5000000.0,0.0,4000000.0,7000000.0,10000000.0,,2000000.0,,28000000.0,0.031,10000000.0,-48000000.0,1000000.0,49000000.0,,-789000000.0,99000000.0,7000000.0,,-14000000.0,-28000000.0,108000000.0,42000000.0,,187000000.0,3000000.0,3000000.0,,1000000.0,341000000.0,33000000.0,-84000000.0,543000000.0,-1909000000.0,0.22,4.45,4.44,678000000.0,21000000.0,-0.02,0.01,0.01,-2000000.0,15000000.0,-574000000.0,,-980000000.0,1174000000.0,-444000000.0,101000000.0,0.0,13000000.0,20000000.0,90000000.0,-9000000.0,-41000000.0,-76000000.0,4000000.0,-6000000.0,4000000.0,,80000000.0,21000000.0,-10000000.0,-258000000.0,,4000000.0,-31000000.0,,-222000000.0,96000000.0,-79000000.0,-733000000.0,,,-65000000.0,-48000000.0,,3178000.0,42000000.0,11000000.0,-7000000.0,344000000.0,21.0,457000000.0,104000000.0,,112000000.0,479000000.0,927000000.0,,135000000.0,,190000000.0,0.0,,127000000.0,612000000.0,27000000.0,153000000.0,70000000.0,21000000.0,12000000.0,16000000.0,17000000.0,18000000.0,,30000000.0,44000000.0,192000000.0,11565000000.0,15842000000.0,1128000000.0,186000000.0,33000000.0,32000000.0,425000000.0,,1500000000.0,,0.0,0.0,,4891000000.0,0.0,6995000000.0,4479000000.0,281000000.0,756000000.0,550000000.0,500000000.0,62000000.0,4891000000.0,2000000.0,179000000.0,,0.0,38.0,0.0,6706000000.0,28000000.0,4000000.0,-1980000000.0,5459000000.0,-1299000000.0,36000000.0,-66000000.0,117000000.0,,,,7064000000.0,-85000000.0,511000000.0,5475000000.0,2000000.0,-1020000000.0,15000000.0,123000000.0,20000000.0,103000000.0,,120000000.0,39000000.0,10000000.0,14000000.0,19000000.0,22000000.0,112000000.0,,,47000000.0,,0.042,,93000000,0.0,289000000.0,935000000.0,2725000000.0,429000000.0,,3000000.0,,291000000.0,111000000.0,,44000000.0,,-16000000.0,0.0,0.0,,,28000000.0,-18000000.0,44000000.0,106000000.0,136000000.0,0.0,,,2000000.0,1000000.0,2000000.0,,88000000.0,308000000.0,,364000000.0,1000000.0,,-6000000.0,10000000.0,2000000.0,5000000.0,2159000000.0,29000000.0,2000000.0,0.0,19000000.0,,0.0,507000000.0,93000000.0,0.0,11000000.0,,390000000.0,,,0.0,516000000.0,19000000.0,-200000000.0,57000000.0,132000000.0,0.0,14000000.0,,,14000000.0,117000000,,253000000.0,0.0,739000000.0,2486000000.0,,,0.0,0.0,0.0,,,,0.0,-53000000.0,0.0,0.0,-373000000.0,108000000.0,6000000.0,203000000.0,553000000.0,4000000.0,535661000.0,-1242000000.0,232000000.0,8947000000.0,2689000000,285000000.0,,,518000000.0,,,-66000000.0,,,,,,,,972000000.0,,0.0,8000000.0,0.0,0.0,615000000.0,540000.0,,17000000.0,20000000.0,,,,4000000.0,2855000000.0,8529000000.0,4888000000.0,509000000.0,,,6323000000.0,,141000000.0,4947000000.0,1407000000.0,42000000.0,163000000.0,10000000.0,0.0,47000000.0,,,,,,19466670.0,8267000.0,22.32,,55000000.0,,1939000.0,26.98,1987000.0,,144000000.0,22809000.0,,946549.0,24.46,35.4,112000000.0,,16000000.0,,160000000.0,108000000.0,-66000000.0,4249000000.0,4847000000.0,33350000.0,41000.0,2199000.0,-2191000.0,59000000.0,67816810.0,2000000000.0,,,,500000000.0,,6580000000.0,11000000.0,34000000.0,180000000.0,-11000000.0,53000000.0,,1000000.0,,33000000.0,-6000000.0,140000000.0,2000000.0,84000000.0,2000000.0,33000000.0,8000000.0,17000000.0,-17000000.0,,302000000.0,211247000.0,211247000.0,16000000.0,900000000.0,207000000.0,931000000.0,,,,1
4,343000000,309000000.0,28000000.0,4000000.0,6000000.0,8000000.0,4000000.0,36000000.0,139000000.0,4000000.0,629000000,52000000.0,6327000000,3000000.0,406000000.0,-540000000.0,1781000000.0,8152000000.0,,6000000.0,645000.0,,65000000.0,11000000.0,10000000.0,15842000000.0,2326000000.0,140000000.0,1782000000.0,67000000.0,,,,,0.36,0.36,,,,,,,,,,,,132000000.0,348000000.0,6166000000.0,,,,,,,,,,,,,,898000000.0,,348000000.0,-75000000.0,,-27000000.0,75000000.0,0.6,1.25,400000000.0,211357081.0,211289000.0,,,264000000.0,17000000.0,9000000.0,-23000000.0,11000000.0,,112000000.0,,,,2416000000.0,2463000000.0,53000000.0,,,,50000000.0,,,,,,682000.0,,,,,44000000.0,-1257000000.0,,43000000.0,98000000.0,,1440000000.0,,,151000000.0,41000000.0,169000000.0,369000000.0,,,,,,,,17000000.0,139000000.0,,206000000.0,,,,,-1756000000.0,-119000000.0,49000000.0,,,,,,,,,,,,25000000.0,,7000000.0,,1000000.0,14000000.0,1000000.0,,,,,,15000000.0,,,,,,,,,,,,,,,1200.0,,252000000.0,,2.08,,,,7000000.0,9000000.0,,0.06,0.06,3000000.0,,51000000.0,,53000000.0,,84000000.0,0.0,5000000.0,372000000.0,,120000000.0,280000000.0,5000000.0,99000000.0,5000000.0,,173000000.0,186000000.0,,0.0,93000000.0,31000000.0,10000000.0,,15000000.0,1130000000.0,164000000.0,,,,,-0.5,,-0.5,0.378,0.35,0.21,0.21,174000000.0,192000000.0,40000000.0,,,,,,,33000000.0,100000000.0,,,,,,,,,,,,-1127000000.0,15000000.0,22000000.0,,,23000000.0,0.0,,0.0,1000000.0,4000000.0,7000000.0,,1000000.0,,,,,,,60000000.0,,789000000.0,-99000000.0,,0.0,-3000000.0,,203000000.0,42000000.0,,508000000.0,,2000000.0,10000000.0,,,12000000.0,,175000000.0,,,3.51,3.49,667000000.0,10000000.0,,0.03,0.03,-3000000.0,,-221000000.0,,-1025000000.0,53000000.0,-445000000.0,101000000.0,,,,,,,,,,,,,,,,,,-25000000.0,-568000000.0,10000000.0,98000000.0,,387000000.0,0.0,5000000.0,,,0.0,3334000.0,20000000.0,20000000.0,-11000000.0,115000000.0,29.0,,104000000.0,,112000000.0,476000000.0,,,137000000.0,,211000000.0,,213000000.0,,,9000000.0,136000000.0,59000000.0,,11000000.0,12000000.0,17000000.0,18000000.0,,25000000.0,,,11000000000.0,15365000000.0,1128000000.0,1063000000.0,154000000.0,926000000.0,,,1500000000.0,1500000000.0,0.0,,,4891000000.0,,7245000000.0,4675000000.0,62000000.0,0.0,719000000.0,0.0,500000000.0,4891000000.0,,98000000.0,,,35.0,,,16000000.0,,,,,280000000.0,,385000000.0,,1070000000.0,1954000000.0,,-178000000.0,516000000.0,5475000000.0,2000000.0,-356000000.0,5000000.0,111000000.0,,,,,28000000.0,12000000.0,16000000.0,20000000.0,21000000.0,107000000.0,,,,,,,93000000,,,,,419000000.0,,2000000.0,,38000000.0,120000000.0,,25000000.0,,15000000.0,,,-5000000.0,-10000000.0,64000000.0,-40000000.0,41000000.0,29000000.0,7000000.0,0.0,,,83000000.0,0.0,,,76000000.0,,,334000000.0,,,-20000000.0,10000000.0,96000000.0,,,,25000000.0,2000000.0,6000000.0,,,,202000000.0,0.0,11000000.0,1581000000.0,,,0.0,32000000.0,516000000.0,37000000.0,,57000000.0,127000000.0,,,,,14000000.0,117000000,,253000000.0,,,,,707000000.0,15000000.0,,,,887000000.0,0.0,,-49000000.0,253000000.0,,,,,,,0.0,,,238000000.0,,2689000000,,,,569000000.0,13000000.0,5000000.0,-15000000.0,,,,,,,0.0,,,-209000000.0,16000000.0,120000000.0,0.0,615000000.0,,,14000000.0,3000000.0,,,,22000000.0,2844000000.0,7254000000.0,1664000000.0,170000000.0,,,2107000000.0,,339000000.0,1684000000.0,3224000000.0,89000000.0,318000000.0,,0.0,,,,,,,17317903.0,8442000.0,22.78,,,,269000.0,31.34,2463000.0,,65000000.0,,22.36,1079549.0,25.01,23.47,62000000.0,,,,15000000.0,116000000.0,,4349000000.0,4365000000.0,,,,-5440000.0,59000000.0,9775873.0,306000000.0,66691.0,,2500000000.0,500000000.0,,6580000000.0,,35000000.0,,,-53000000.0,,,2000000.0,,,,,,,,,,,,,211284000.0,211284000.0,,,,,,,,1
5,343000000,309000000.0,29000000.0,14000000.0,6000000.0,8000000.0,4000000.0,36000000.0,,,629000000,52000000.0,6327000000,3000000.0,419000000.0,-664000000.0,1786000000.0,8152000000.0,,6000000.0,645000.0,86000000.0,,10000000.0,8000000.0,15365000000.0,,140000000.0,,88000000.0,,0.0,1208000000.0,,0.96,0.95,,,,,,,,,,,,485000000.0,150000000.0,7236000000.0,,,,,,,,,,,,9000000.0,89000000.0,2362000000.0,-638000000.0,334000000.0,-122000000.0,,-118000000.0,429000000.0,2.4,1.25,400000000.0,211358955.0,,,,264000000.0,6000000.0,66000000.0,2000000.0,68000000.0,,,,,1348000000.0,1314000000.0,10701000000.0,,,-63000000.0,16000000.0,,4896000000.0,,,5000000.0,,673000.0,,,,,120000000.0,,289000000.0,34000000.0,98000000.0,,1602000000.0,456000000.0,1458000000.0,151000000.0,41000000.0,187000000.0,336000000.0,59000000.0,80000000.0,18000000.0,,57000000.0,102000000.0,121000000.0,14000000.0,144000000.0,1002000000.0,206000000.0,185000000.0,,577000000.0,5700000000.0,-2079000000.0,-104000000.0,,,,,,,,,,,,,25000000.0,,7000000.0,,,10000000.0,1000000.0,,,,,,15000000.0,,,6400000000.0,5000000000.0,6600000000.0,2500000000.0,2900000000.0,,,,,,,,,346000000.0,376000000.0,417000000.0,2.39,,,972000000.0,14000000.0,,,,,5000000.0,,,,122000000.0,,118000000.0,,63000000.0,1573000000.0,,,,30000000.0,287000000.0,1000000.0,,,93000000.0,,887000000.0,,26000000.0,14000000.0,,16000000.0,,450000000.0,0.0,,,,-1.75,0.02,-1.75,0.168,0.34,,0.21,174000000.0,192000000.0,43000000.0,,,,4937000000.0,,,34000000.0,100000000.0,,28000000.0,5000000.0,,89000000.0,25000000.0,-1000000.0,101000000.0,6000000.0,540000000.0,,-62000000.0,,15000000.0,10000000.0,12000000.0,16000000.0,0.0,,0.0,1000000.0,2000000.0,5000000.0,,1000000.0,13000000.0,19000000.0,0.031,7000000.0,-4000000.0,-5000000.0,11000000.0,,,,21000000.0,,-18000000.0,-49000000.0,95000000.0,,,327000000.0,0.0,114000000.0,,357000000.0,,12000000.0,,198000000.0,-387000000.0,0.04,4.0,3.99,480000000.0,32000000.0,,,,0.0,,-900000000.0,,-1187000000.0,63000000.0,-444000000.0,,0.0,,,,-13000000.0,,,,,0.0,,,,,-255000000.0,,0.0,-18000000.0,,-37000000.0,29000000.0,-42000000.0,,,-3000000.0,-1000000.0,-54000000.0,97000000.0,2787000.0,,9000000.0,-5000000.0,462000000.0,29000000.0,161000000.0,,,112000000.0,531000000.0,,,139000000.0,,211000000.0,,,121000000.0,,35000000.0,127000000.0,50000000.0,,12000000.0,12000000.0,13000000.0,19000000.0,,20000000.0,47000000.0,,11196000000.0,15250000000.0,,690000000.0,,0.0,,,1500000000.0,,425000000.0,,,,0.0,7360000000.0,2798000000.0,500000000.0,1876000000.0,0.0,719000000.0,0.0,,,98000000.0,,0.0,37.0,80000000.0,6675000000.0,10000000.0,,-100000000.0,-102000000.0,-436000000.0,-1176000000.0,-2000000.0,,,,,7084000000.0,-97000000.0,516000000.0,5475000000.0,,-2601000000.0,20000000.0,107000000.0,16000000.0,95000000.0,20000000.0,106000000.0,27000000.0,14000000.0,17000000.0,21000000.0,26000000.0,105000000.0,,,,,0.042,,93000000,4000000.0,318000000.0,,,292000000.0,,7000000.0,,733000000.0,9000000.0,,-2000000.0,,-54000000.0,,-1000000.0,51000000.0,35000000.0,,-8000000.0,74000000.0,72000000.0,-35000000.0,,,,,1000000.0,-6000000.0,,96000000.0,267000000.0,,318000000.0,1000000.0,,-6000000.0,0.0,24000000.0,11000000.0,,10000000.0,-8000000.0,2000000.0,7000000.0,,,53000000.0,330000000.0,23000000.0,,,56000000.0,,0.0,,,64000000.0,-15000000.0,,128000000.0,0.0,,,,14000000.0,117000000,,253000000.0,,739000000.0,,,,,781000000.0,669000000.0,0.0,887000000.0,0.0,440000000.0,-2000000.0,253000000.0,-887000000.0,0.0,0.0,14000000.0,,46000000.0,0.0,535759000.0,-266000000.0,,8880000000.0,2689000000,252000000.0,,,569000000.0,25000000.0,12000000.0,-28000000.0,,,,,,,0.0,1000000.0,,209000000.0,8000000.0,,0.0,,,,35000000.0,4000000.0,,,,16000000.0,2658000000.0,,5954000000.0,0.0,4000000.0,3000000.0,8100000000.0,,148000000.0,1793000000.0,1805000000.0,47000000.0,162000000.0,23000000.0,,6000000.0,,,,,,21646924.0,9152000.0,23.63,,,,1603000.0,25.98,2123000.0,,528000000.0,17055000.0,,4200554.0,,,338000000.0,,,,6000000.0,110000000.0,5000000.0,4044000000.0,4054000000.0,,,5404000.0,7226000.0,59000000.0,0.0,,-66000.0,,,210000000.0,,6580000000.0,9000000.0,,251000000.0,21000000.0,0.0,,0.0,,15000000.0,2000000.0,159000000.0,,,,,,,,,,211258000.0,211258000.0,,,,,,,,1
6,409000000,309000000.0,,6000000.0,5000000.0,5000000.0,4000000.0,36000000.0,31000000.0,15000000.0,661000000,55000000.0,6357000000,3000000.0,419000000.0,-664000000.0,1786000000.0,8152000000.0,,6000000.0,,165000000.0,69000000.0,11000000.0,12000000.0,15250000000.0,2315000000.0,140000000.0,1782000000.0,88000000.0,,22000000.0,,,,,,,,,,,,,,,,,361000000.0,2003000000.0,,,,,,,,,,,,,4102000000.0,1397000000.0,-548000000.0,334000000.0,-181000000.0,,-22000000.0,66000000.0,,1.25,400000000.0,211358955.0,211356803.0,,,,5000000.0,,2000000.0,,,140000000.0,,23200000.0,2795000000.0,3609000000.0,1605000000.0,-73000000.0,8000000.0,-100000000.0,,34000000.0,4808000000.0,,,,,565000.0,,52720.0,11000000.0,-13000000.0,120000000.0,39000000.0,,17000000.0,80000000.0,-11000000.0,,,,207000000.0,37000000.0,,,,,,,,,214000000.0,,,,306000000.0,,,,,,,490000000.0,,,,,0.0,,,,,,,1000000.0,,4000000.0,,1000000.0,8000000.0,1000000.0,,,,,,56000000.0,,,,,,,,,,,0.0,,,19000000.0,,178000000.0,503000000.0,,,,,,,-6000000.0,,0.04,0.04,,,51000000.0,,122000000.0,,118000000.0,,3000000.0,,,,,,,6000000.0,,,261000000.0,,,,26000000.0,14000000.0,,,,150000000.0,,,,,-2.58,,-2.58,0.206,0.31,,,145000000.0,143000000.0,47000000.0,5000000.0,9000000.0,,,,0.0,31000000.0,,,28000000.0,,,,,0.0,,,501000000.0,2000000.0,,,10000000.0,,,10000000.0,0.0,,0.0,1000000.0,2000000.0,2000000.0,,0.0,,,,8000000.0,-17000000.0,,63000000.0,,0.0,0.0,,0.0,,,310000000.0,40000000.0,,829000000.0,,92000000.0,,,450000000.0,117000000.0,-11000000.0,442000000.0,-5000000.0,,3.97,3.96,,,,0.02,0.02,,,,,,,-453000000.0,34000000.0,,0.0,8000000.0,154000000.0,-3000000.0,0.0,0.0,6000000.0,-193000000.0,,,94000000.0,,0.0,-254000000.0,,-22000000.0,33000000.0,-551000000.0,-211000000.0,56000000.0,-34000000.0,,0.0,-5000000.0,-11000000.0,218000000.0,,3247000.0,0.0,35000000.0,-21000000.0,,9000000.0,213000000.0,74000000.0,,,,,,,,205000000.0,,192000000.0,,,,126000000.0,48000000.0,,14000000.0,14000000.0,14000000.0,15000000.0,,18000000.0,,,11196000000.0,15250000000.0,1072000000.0,690000000.0,154000000.0,0.0,,,1500000000.0,1500000000.0,425000000.0,,,4891000000.0,0.0,7706000000.0,3549000000.0,0.0,0.0,1876000000.0,0.0,719000000.0,4891000000.0,,98000000.0,,,,,,10000000.0,4000000.0,-164000000.0,-74000000.0,-310000000.0,,-12000000.0,143000000.0,,1070000000.0,1954000000.0,6910000000.0,,516000000.0,5475000000.0,2000000.0,,,108000000.0,,,,,34000000.0,21000000.0,24000000.0,27000000.0,32000000.0,131000000.0,,,36000000.0,,,,133000000,,,,,289000000.0,,,,,128000000.0,,,,,,,-259000000.0,-167000000.0,-6000000.0,,,,,0.0,,,81000000.0,,-8000000.0,,,,,308000000.0,,,-28000000.0,4000000.0,163000000.0,,,17000000.0,-13000000.0,2000000.0,9000000.0,,,106000000.0,458000000.0,,,1580000000.0,89000000.0,,,32000000.0,471000000.0,143000000.0,-22000000.0,56000000.0,138000000.0,,,,,,108000000,,253000000.0,,739000000.0,403000000.0,,707000000.0,24000000.0,,,0.0,,100000000.0,,-3000000.0,253000000.0,,0.0,,,0.0,78000000.0,0.0,535840000.0,-266000000.0,285000000.0,4520000000.0,2611000000,,,,560000000.0,13000000.0,4000000.0,-42000000.0,,,,,,,-100000000.0,19000000.0,,,24000000.0,120000000.0,253000000.0,615000000.0,523000.0,,34000000.0,2000000.0,,,,148000000.0,2658000000.0,7403000000.0,1578000000.0,215000000.0,,,,,509000000.0,1633000000.0,4888000000.0,138000000.0,479000000.0,22000000.0,0.0,11000000.0,,,,,,21092207.0,,,,13000000.0,,,,6122000.0,,,,23.12,4180264.0,,,,,14000000.0,,1000000.0,150000000.0,,4044000000.0,4054000000.0,0.0,0.0,,5294000.0,59000000.0,,,0.0,,500000000.0,135000000.0,,6580000000.0,,,,-21000000.0,0.0,,,0.0,,-2000000.0,,,,,,,,,,,,,,,,,,,,1
7,335000000,,34000000.0,,7000000.0,,15000000.0,34000000.0,12000000.0,2000000.0,597000000,48000000.0,6428000000,,,-664000000.0,1786000000.0,,,4000000.0,,,65000000.0,12000000.0,11000000.0,15250000000.0,3290000000.0,,1782000000.0,88000000.0,,0.0,,,,,,,,,,,,,,,,,211000000.0,3736000000.0,,,,,,,,,,,,9000000.0,2294000000.0,835000000.0,,334000000.0,,,-34000000.0,134000000.0,0.25,,,211608529.0,211357081.0,,,,6000000.0,57000000.0,,57000000.0,,157000000.0,,23345000.0,1447000000.0,1193000000.0,3058000000.0,,,-119000000.0,,36000000.0,6628000000.0,,,5000000.0,,,,,,,120000000.0,,354000000.0,25000000.0,75000000.0,,966000000.0,-150000000.0,869000000.0,128000000.0,0.0,110000000.0,310000000.0,59000000.0,100000000.0,17000000.0,,369000000.0,101000000.0,0.0,10000000.0,97000000.0,850000000.0,410000000.0,165000000.0,,538000000.0,6500000000.0,,,,,,,,,,,,,,,1000000.0,,,,,7000000.0,1000000.0,,,,,,56000000.0,,,948000000.0,726000000.0,971000000.0,1800000000.0,2100000000.0,,,,,,,,,332000000.0,,454000000.0,,,,972000000.0,2000000.0,-7000000.0,,,,1000000.0,,51000000.0,,122000000.0,,118000000.0,,,386000000.0,,,,9000000.0,44000000.0,,,,,,,,26000000.0,14000000.0,,,,598000000.0,,,,,,0.49,,0.098,0.3,,,135000000.0,157000000.0,,,,,,,,30000000.0,,,28000000.0,5000000.0,,,,,,,,,,12000000.0,,7000000.0,8000000.0,,,,,,,,,,,13000000.0,0.029,1000000.0,17000000.0,,9000000.0,,0.0,,42000000.0,,0.0,-49000000.0,107000000.0,40000000.0,,321000000.0,,,,,,84000000.0,,275000000.0,-568000000.0,0.47,,,,22000000.0,0.02,0.04,0.04,2000000.0,,-176000000.0,,57000000.0,47000000.0,,37000000.0,,,,,,,,,,,,,,,,,,,,,,,,,,,,-13000000.0,,0.0,15000000.0,-10000000.0,106000000.0,9.0,,104000000.0,,119000000.0,542000000.0,,,,,188000000.0,,213000000.0,,,,,,,,,,,,,38000000.0,,11196000000.0,15250000000.0,1069000000.0,690000000.0,154000000.0,,,,,,425000000.0,,,4891000000.0,,7441000000.0,3863000000.0,150000000.0,436000000.0,0.0,1051000000.0,0.0,4891000000.0,,43000000.0,,50000000.0,,,,10000000.0,,,,,-264000000.0,-10000000.0,144000000.0,,,,6923000000.0,,511000000.0,,0.0,-330000000.0,,,17000000.0,90000000.0,,101000000.0,40000000.0,27000000.0,29000000.0,32000000.0,35000000.0,161000000.0,,,42000000.0,,0.041,,106000000,,,,,289000000.0,,0.0,,344000000.0,8000000.0,,-27000000.0,,14000000.0,,0.0,-1075000000.0,-698000000.0,-3000000.0,11000000.0,30000000.0,43000000.0,-59000000.0,,,,,0.0,-28000000.0,,,,,308000000.0,2000000.0,,,-6000000.0,,5000000.0,,,,,9000000.0,,,,,,,1580000000.0,,,,,422000000.0,,,57000000.0,191000000.0,0.0,,,,,106000000,,,,,,,,,897000000.0,669000000.0,,887000000.0,,440000000.0,,253000000.0,-887000000.0,0.0,,15000000.0,,,,536423000.0,-382000000.0,,4868000000.0,2599000000,,,,590000000.0,19000000.0,9000000.0,-57000000.0,,,,,,,100000000.0,,,209000000.0,8000000.0,120000000.0,253000000.0,615000000.0,,,,2000000.0,,,,,2658000000.0,,1422000000.0,211000000.0,,,1275000000.0,,170000000.0,3398000000.0,1664000000.0,49000000.0,161000000.0,,,,,,,,,20554887.0,,,,,,,,,,,12285000.0,,6417318.0,,,,,,,2000000.0,126000000.0,,4044000000.0,4054000000.0,,,,1376000.0,58813151.0,,,,,500000000.0,440000000.0,,,10000000.0,,,148000000.0,4000000.0,,,,4000000.0,3000000.0,16000000.0,,,,,,,,,,211298000.0,211298000.0,,,,,,,,1
8,351000000,390000000.0,,,,,,37000000.0,4000000.0,2000000.0,606000000,47000000.0,6408000000,,419000000.0,-664000000.0,1786000000.0,8159000000.0,,3000000.0,,247000000.0,62000000.0,,,15250000000.0,3012000000.0,0.0,2815000000.0,988000000.0,,,,,,,,,,,,,,,,,,,514000000.0,4199000000.0,,,,,,,,,,,,,2294000000.0,,-666000000.0,334000000.0,-195000000.0,,,,0.25,,,211358955.0,211358955.0,,,264000000.0,,,0.0,,,215000000.0,,,4247000000.0,5392000000.0,,,,,-11000000.0,42000000.0,,,,,,,,71056.0,,,120000000.0,26000000.0,,6000000.0,83000000.0,,789000000.0,-14000000.0,700000000.0,111000000.0,0.0,144000000.0,260000000.0,,,,,,,,,89000000.0,883000000.0,338000000.0,130000000.0,,540000000.0,,,,,,,,,0.0,,,,,,,10000000.0,,,,,5000000.0,,,,,,,53000000.0,,,,,,,,,,,0.0,,,,,,495000000.0,,,,,,-8000000.0,-11000000.0,,1.76,1.75,-2000000.0,,19000000.0,,99000000.0,,94000000.0,,3000000.0,760000000.0,,,,17000000.0,126000000.0,2000000.0,,,33000000.0,,,,26000000.0,15000000.0,,,,,,,,,-0.83,0.29,-0.83,-0.179,0.24,0.21,,152000000.0,161000000.0,,,,,,,0.0,30000000.0,,,,,,,,-197000000.0,,,462000000.0,,,,,,,,,,,,,,,,11000000.0,,,-10000000.0,-34000000.0,,-69000000.0,,0.0,,,152000000.0,-1000000.0,-50000000.0,436000000.0,40000000.0,,1160000000.0,,33000000.0,,,333000000.0,84000000.0,,740000000.0,,0.25,0.47,0.47,0.0,,0.04,0.02,0.02,4000000.0,,-208000000.0,,47000000.0,,,23000000.0,,0.0,,113000000.0,-4000000.0,0.0,,3000000.0,,,,,21000000.0,0.0,-344000000.0,,-11000000.0,,-521000000.0,-247000000.0,80000000.0,-46000000.0,,-52000000.0,-6000000.0,-15000000.0,164000000.0,,2868000.0,0.0,47000000.0,,223000000.0,17.0,381000000.0,73000000.0,,119000000.0,542000000.0,,,,,186000000.0,,,,,33000000.0,,,,,,,,,,,,11196000000.0,15250000000.0,957000000.0,666000000.0,137000000.0,,,,,,425000000.0,,,4891000000.0,1981000000.0,7441000000.0,3326000000.0,0.0,312000000.0,436000000.0,0.0,1051000000.0,4891000000.0,,25000000.0,,,,80000000.0,,10000000.0,,-590000000.0,200000000.0,-276000000.0,-264000000.0,-17000000.0,144000000.0,,1070000000.0,0.0,,,511000000.0,5475000000.0,0.0,-330000000.0,21000000.0,,,,19000000.0,,35000000.0,18000000.0,24000000.0,26000000.0,29000000.0,78000000.0,,,,,,,114000000,2000000.0,,,,289000000.0,,-1000000.0,,373000000.0,73000000.0,,,,25000000.0,,,,,-2000000.0,-1000000.0,,,,-1000000.0,,,-83000000.0,,-10000000.0,,,,,308000000.0,,,-5000000.0,11000000.0,174000000.0,,,22000000.0,-32000000.0,,17000000.0,,,116000000.0,,11000000.0,,1580000000.0,132000000.0,,,34000000.0,569000000.0,,10000000.0,56000000.0,206000000.0,2000000.0,,,,14000000.0,97000000,,,,,,,0.0,27000000.0,,,0.0,,100000000.0,,-4000000.0,,,,,,,92000000.0,1000000.0,536558000.0,-116000000.0,281000000.0,,2534000000,,,,583000000.0,,,,,,,,,,100000000.0,422000000.0,,209000000.0,34000000.0,120000000.0,253000000.0,615000000.0,,,15000000.0,2000000.0,,,,4000000.0,2658000000.0,7082000000.0,3032000000.0,366000000.0,4000000.0,9000000.0,1275000000.0,,,3410000000.0,,194000000.0,677000000.0,1000000.0,1000000.0,18000000.0,,,,,,20000000.0,,,,18000000.0,,,,,,,,24.19,6783669.0,,,,,14000000.0,,1000000.0,124000000.0,,4044000000.0,4054000000.0,,0.0,,2570000.0,58813000.0,,,-2290000.0,,500000000.0,440000000.0,,6574000000.0,,,177000000.0,,,,,,,,,,,,,,,,,,211328000.0,211328000.0,,,,,,,,1
9,331000000,420000000.0,32000000.0,,,,,24000000.0,19000000.0,4000000.0,587000000,47000000.0,6324000000,,419000000.0,,,8166000000.0,,3000000.0,,,63000000.0,,,15250000000.0,3033000000.0,0.0,1934000000.0,0.0,,0.0,,,,,,,,,,,,,,,,,153000000.0,1929000000.0,,,,,,,,,,,,0.0,2294000000.0,835000000.0,,,,,-12000000.0,68000000.0,0.5,,,,211358955.0,,,265000000.0,3000000.0,1131000000.0,2000000.0,1133000000.0,,131000000.0,,,,4831000000.0,1453000000.0,-69000000.0,26000000.0,-11000000.0,,46000000.0,6008000000.0,,,5000000.0,,,,,39000000.0,66000000.0,,,335000000.0,6000000.0,75000000.0,4000000.0,935000000.0,30000000.0,863000000.0,228000000.0,44000000.0,86000000.0,223000000.0,56000000.0,78000000.0,14000000.0,,260000000.0,80000000.0,,,72000000.0,833000000.0,14000000.0,130000000.0,,523000000.0,6100000000.0,,,808000000.0,,,,,,,,,,,,10000000.0,,,,,,,,,,,,53000000.0,,,6500000000.0,5600000000.0,6600000000.0,,,,,,,,,20000000.0,,160000000.0,123000000.0,,,,,,-17000000.0,,,,,-5000000.0,,211000000.0,,107000000.0,,89000000.0,,4000000.0,,,,,,,3000000.0,,,87000000.0,,,,14000000.0,12000000.0,,,,156000000.0,,,,,-0.1,0.08,-0.1,-0.233,0.32,0.21,,161000000.0,188000000.0,,4000000.0,10000000.0,,,,,31000000.0,,,,0.0,,,,,,,,5000000.0,,,,5000000.0,5000000.0,,,,,,,,,,,9000000.0,0.029,,34000000.0,,63000000.0,,-1000000.0,48000000.0,25000000.0,,-2000000.0,-1000000.0,,40000000.0,,1123000000.0,,,,,312000000.0,82000000.0,122000000.0,298000000.0,-525000000.0,0.08,0.25,0.25,,998000000.0,0.0,,,,,,,,42000000.0,2000000.0,25000000.0,,,-8000000.0,152000000.0,0.0,,21000000.0,13000000.0,-4000000.0,,,101000000.0,0.0,,,,,79000000.0,,,103000000.0,,,,,,-65000000.0,,,0.0,,,261000000.0,,,105000000.0,,116000000.0,542000000.0,,,,,188000000.0,,190000000.0,,,,,,,,,,,,,37000000.0,,,,918000000.0,578000000.0,0.0,,,,1500000000.0,,,,,4891000000.0,281000000.0,7441000000.0,3333000000.0,978000000.0,300000000.0,272000000.0,210000000.0,0.0,4891000000.0,,4000000.0,,240000000.0,,,,,4000000.0,,,,-370000000.0,,,,1070000000.0,0.0,9438000000.0,,511000000.0,5250000000.0,0.0,-392000000.0,,,17000000.0,91000000.0,,102000000.0,35000000.0,18000000.0,24000000.0,26000000.0,29000000.0,78000000.0,,,38000000.0,,0.039,,78000000,,,,,269000000.0,,1000000.0,,,,,17000000.0,,,,1000000.0,-5000000.0,-15000000.0,-207000000.0,,30000000.0,21000000.0,-24000000.0,,,,14000000.0,,-10000000.0,,,,,284000000.0,1000000.0,,,,,17000000.0,,,,,26000000.0,,,,129000000.0,,,1580000000.0,,,,,1319000000.0,35000000.0,,47000000.0,233000000.0,,,,,,80000000,,362000000.0,,,0.0,,0.0,,897000000.0,669000000.0,0.0,,,440000000.0,,,-887000000.0,-3000000.0,,19000000.0,0.0,,3000000.0,,-116000000.0,293000000.0,4956000000.0,2623000000,,,,525000000.0,-45000000.0,-29000000.0,-20000000.0,,,,,,,,,,209000000.0,,,253000000.0,615000000.0,462000.0,,,2000000.0,,,,,,6365000000.0,3351000000.0,378000000.0,,,2666000000.0,,,1765000000.0,,,650000000.0,,,,,,,,,20000000.0,,,,,,,,,,,12763000.0,,1357071.0,,,,,,,,,,,,0.0,,,,,,,,,,440000000.0,,6571000000.0,9000000.0,,,0.0,0.0,,,,3000000.0,15000000.0,12000000.0,,,,,,,,,,,,,,,,,,,1
10,331000000,500000000.0,,,,,,24000000.0,19000000.0,,587000000,,6324000000,3000000.0,439000000.0,-635000000.0,1789000000.0,8178000000.0,,,,458000000.0,,,,,3033000000.0,199000000.0,1934000000.0,0.0,,,,,,,,,,,,,,,,,,,557000000.0,2196000000.0,,,,,,,,,,,,0.0,2294000000.0,835000000.0,-425000000.0,,,,,,,1.25,400000000.0,211557320.0,211358955.0,,,670000000.0,,,,,,131000000.0,,0.0,1452000000.0,,,,,,,46000000.0,,,,,,,,,,,106000000.0,-77000000.0,,6000000.0,75000000.0,,,,,228000000.0,8000000.0,,,,,,,,,,,,82000000.0,206000000.0,,,,,,,,,,,,,,,,,,,-6000000.0,,,,,,,,,,,,57000000.0,,,,,,,,,,,,,,,,,,,,,,,-10000000.0,-5000000.0,,1.82,1.8,-3000000.0,,211000000.0,,,,,,1000000.0,374000000.0,,,,8000000.0,82000000.0,,,,,,,,,,,,,319000000.0,,,,,-0.1,,-0.1,,0.32,0.21,,161000000.0,188000000.0,,,,,,,,31000000.0,,,,0.0,,,,,,,,,,9000000.0,,,,,,,,,,,,,8000000.0,,,-18000000.0,41000000.0,,,,1000000.0,,,152000000.0,,-50000000.0,382000000.0,,,,,30000000.0,,,198000000.0,,,,-9000000.0,0.23,0.6,0.59,0.0,,0.0,,,1000000.0,,-32000000.0,,-10000000.0,-576000000.0,,25000000.0,,,,112000000.0,4000000.0,,,7000000.0,,,,,,,-349000000.0,,-4000000.0,,-583000000.0,-376000000.0,47000000.0,-30000000.0,,-103000000.0,,-23000000.0,436000000.0,-22000000.0,3488000.0,,,,111000000.0,24.0,432000000.0,105000000.0,,120000000.0,542000000.0,,,,,188000000.0,,,,,,,,,,,,,,,,,11118000000.0,15175000000.0,918000000.0,0.0,0.0,,,,1500000000.0,,245000000.0,,,,281000000.0,7441000000.0,,,,,,,,,,,190000000.0,,,,11000000.0,,-526000000.0,263000000.0,-162000000.0,,-5000000.0,340000000.0,,,,,,,5250000000.0,4000000.0,,,,,,21000000.0,,35000000.0,18000000.0,24000000.0,26000000.0,29000000.0,78000000.0,,,,,,,82000000,,,,,274000000.0,,,,29000000.0,,,,,11000000.0,,,27000000.0,8000000.0,,-12000000.0,,,,1000000.0,,,110000000.0,2000000.0,0.0,,,,,275000000.0,,,-11000000.0,1000000.0,193000000.0,,,29000000.0,-5000000.0,,33000000.0,,,127000000.0,,22000000.0,,,187000000.0,,,36000000.0,1319000000.0,,-19000000.0,47000000.0,1000000.0,,,,,14000000.0,80000000,,,,,,,,34000000.0,,,,0.0,,,-4000000.0,,,,,,0.0,92000000.0,0.0,536923000.0,-387000000.0,283000000.0,,2623000000,,,,525000000.0,-94000000.0,-62000000.0,-35000000.0,,,,,,,,854000000.0,,,,,,,,,7000000.0,15000000.0,,,,11000000.0,2628000000.0,1693000000.0,1610000000.0,155000000.0,3000000.0,18000000.0,,,,1773000000.0,,116000000.0,179000000.0,0.0,7000000.0,26000000.0,,,,,,19000000.0,,,,,,,,,,,,25.88,3078324.0,,,,,,,,,,4046000000.0,,,,,,,,,2290000.0,,,440000000.0,,6546000000.0,,,,,,,,,,,,,,,,,,,,,211356000.0,211356000.0,,,,,,,,1
11,331000000,450000000.0,30000000.0,,,,,24000000.0,19000000.0,,587000000,47000000.0,6324000000,3000000.0,441000000.0,-592000000.0,1796000000.0,8208000000.0,,3000000.0,,,65000000.0,,,,3033000000.0,,1934000000.0,1934000000.0,,0.0,,,,,,,,,,,,,,,,,,5603000000.0,,,,,,,,,,,,0.0,,835000000.0,,,1319000000.0,,225000000.0,192000000.0,0.25,1.25,400000000.0,211608529.0,211358955.0,,,670000000.0,3000000.0,1065000000.0,0.0,1065000000.0,,131000000.0,,,,1324000000.0,4342000000.0,-78000000.0,,-39000000.0,-16000000.0,46000000.0,5933000000.0,,,5000000.0,,,,,6000000.0,,71000000.0,,267000000.0,18000000.0,,1000000.0,736000000.0,254000000.0,664000000.0,228000000.0,8000000.0,64000000.0,203000000.0,56000000.0,0.0,,,395000000.0,76000000.0,,,72000000.0,,206000000.0,70000000.0,,496000000.0,6400000000.0,,,,,,,,,,,,,,,155000000.0,,,,,,,,,,,,57000000.0,,,5400000000.0,4700000000.0,5500000000.0,,,,,,-3000000.0,,,,,314000000.0,243000000.0,,,,,,-19000000.0,,,,,-6000000.0,,211000000.0,,,,,,,,,,,,,1000000.0,,,54000000.0,,,,,,,,,,,,,,,0.23,,,0.33,0.21,,161000000.0,188000000.0,,,,,,,,30000000.0,,,,1000000.0,,,,,,,,,,,,,,,,,,,,,,,,,,,,,4000000.0,,,,46000000.0,,-5000000.0,-26000000.0,118000000.0,,,254000000.0,,,,,,-35000000.0,,,8000000.0,0.16,,,,966000000.0,,0.13,0.13,11000000.0,,,,,-445000000.0,15000000.0,25000000.0,,,,,,,,,,,,,0.0,,,,,61000000.0,,-251000000.0,15000000.0,,,,2000000.0,,-93000000.0,,,13000000.0,12000000.0,,155000000.0,24000000.0,,105000000.0,,120000000.0,,,,,,,,211000000.0,,,29000000.0,,,,,,,,,,38000000.0,,10597000000.0,14708000000.0,918000000.0,0.0,690000000.0,,,,1500000000.0,,140000000.0,,,,281000000.0,,,,,,,,,,,,290000000.0,,,,11000000.0,,,,,-106000000.0,,196000000.0,,,,,,,5099000000.0,4000000.0,-62000000.0,20000000.0,,,,,,,,,,,,,,43000000.0,,,,82000000,,,,,267000000.0,,,,,16000000.0,,19000000.0,,,,1000000.0,16000000.0,-12000000.0,6000000.0,,166000000.0,-51000000.0,-18000000.0,0.0,,,96000000.0,,-2000000.0,,,,,277000000.0,1000000.0,,,14000000.0,,,,,,2000000.0,37000000.0,,,,257000000.0,,,,,,,,1319000000.0,68000000.0,,47000000.0,5000000.0,,,,,14000000.0,80000000,,362000000.0,,,0.0,,,,,,0.0,0.0,0.0,,-6000000.0,,,-3000000.0,,20000000.0,0.0,,3000000.0,,,,5233000000.0,2623000000,,,,525000000.0,-139000000.0,-92000000.0,-52000000.0,,,,,,,0.0,,,302000000.0,7000000.0,0.0,,,,,,16000000.0,,,,,2631000000.0,1808000000.0,1773000000.0,163000000.0,,,1391000000.0,,,5141000000.0,,51000000.0,172000000.0,,17000000.0,,,,,,,22000000.0,,,,,,,,,,,14712000.0,,4333908.0,,,,,,,,,,4100000000.0,4057000000.0,0.0,,,,0.0,,,0.0,,,440000000.0,,6530000000.0,8000000.0,,26000000.0,,,,,,1000000.0,1000000.0,5000000.0,,,,,,,,,,,,,,,,,,,1
12,331000000,450000000.0,,,,,,24000000.0,0.0,,587000000,47000000.0,6324000000,3000000.0,401000000.0,-643000000.0,4547000000.0,8208000000.0,,3000000.0,,,63000000.0,,,15175000000.0,3033000000.0,0.0,1908000000.0,1908000000.0,,0.0,,,,,,,,,,,,,,,,,,6390000000.0,,,,,,,,,,,,,,,,259000000.0,,,,,,1.25,400000000.0,535935395.0,,,,670000000.0,,,2000000.0,,,131000000.0,,0.0,5592000000.0,1177000000.0,,-63000000.0,-21000000.0,-3000000.0,-18000000.0,46000000.0,5894000000.0,,,,,,,,-60000000.0,21000000.0,52000000.0,-26000000.0,,27000000.0,75000000.0,10000000.0,709000000.0,293000000.0,644000000.0,228000000.0,8000000.0,59000000.0,178000000.0,49000000.0,,,,,,,,65000000.0,,206000000.0,41000000.0,,169000000.0,,,,368000000.0,,,,,,,,,,,,-155000000.0,,,,,,,,,,,,7000000.0,,,,,,,,,,,,,,20000000.0,,198000000.0,,,,,,0.0,-16000000.0,-11000000.0,,2.17,2.16,-5000000.0,,213000000.0,,,,,,1000000.0,1110000000.0,,,,24000000.0,196000000.0,,,,,,,,,,,,,163000000.0,,,,,-0.03,0.16,-0.03,0.25,0.31,0.21,,161000000.0,188000000.0,,4000000.0,11000000.0,,,,,28000000.0,,,,,,,,,,,,13000000.0,,7000000.0,,,,,,,,,,,,,,,,-5000000.0,,,,,,0.0,,0.0,,-26000000.0,,,,245000000.0,,42000000.0,,,970000000.0,156000000.0,43000000.0,,1103000000.0,0.45,,,0.0,,0.0,0.0,0.0,,,-173000000.0,,-44000000.0,-444000000.0,,25000000.0,,,-2000000.0,354000000.0,-16000000.0,,0.0,14000000.0,-7000000.0,,,161000000.0,,,-296000000.0,,,,,,31000000.0,,,-51000000.0,,,,-22000000.0,4561000.0,,,,327000000.0,30.0,460000000.0,105000000.0,,120000000.0,626000000.0,,,,,188000000.0,,0.0,,,,,,,,,,,,,,,9437000000.0,14053000000.0,918000000.0,0.0,690000000.0,,,,1500000000.0,,440000000.0,,,,281000000.0,8008000000.0,,,,,,,,,,,,,,,6000000.0,4000000.0,-498000000.0,276000000.0,-203000000.0,,-23000000.0,196000000.0,,,,9324000000.0,,511000000.0,,4000000.0,,,,,,,,,,,,,,,,25000000.0,,,,82000000,3000000.0,,,,302000000.0,,1000000.0,,398000000.0,,,,,19000000.0,,,124000000.0,60000000.0,14000000.0,25000000.0,,,,,,,,,8000000.0,,,,,267000000.0,,,-6000000.0,13000000.0,19000000.0,6000000.0,,,2000000.0,,14000000.0,,,,,44000000.0,,1581000000.0,,,,6000000.0,1319000000.0,,,47000000.0,32000000.0,12000000.0,,,,14000000.0,80000000,,,,,,,,14000000.0,0.0,0.0,494000000.0,0.0,0.0,0.0,,,0.0,,,,297000000.0,,0.0,537013000.0,-5000000.0,391000000.0,,2623000000,,,,525000000.0,-187000000.0,-121000000.0,-68000000.0,,,,,,,0.0,826000000.0,,,,0.0,,,451000.0,,27000000.0,11000000.0,,,,7000000.0,36000000.0,5373000000.0,4601000000.0,540000000.0,,,1391000000.0,,,5158000000.0,,,317000000.0,4000000.0,,,,,,,,,,,,,,,,,,,,24.96,1389787.0,,,,,,,,,,4610000000.0,4111000000.0,,,,,,,,,,,440000000.0,,6530000000.0,,,,,,,,,,,,,,,,,,,,,211337000.0,211337000.0,,,,,,,,1
13,319000000,450000000.0,,,,,,30000000.0,,,533000000,49000000.0,6304000000,4000000.0,411000000.0,-791000000.0,4552000000.0,8208000000.0,,3000000.0,,,54000000.0,,,14053000000.0,2652000000.0,,0.0,411000000.0,,,,,,,,,,,,,,,,,,,,2191000000.0,,,,,,,,,,,,,,,,153000000.0,,,,,0.55,,1360000000.0,535975518.0,,,,,,134000000.0,0.0,134000000.0,,171000000.0,,,,,,,,,12000000.0,34000000.0,,,,,,,,,,,17000000.0,,,24000000.0,70000000.0,,,268000000.0,,162000000.0,3000000.0,,218000000.0,,,,,,,,,,,195000000.0,,,,,,,,,,,,,,,,,,,-6000000.0,,,,,,,,,,,,17000000.0,,,,4500000000.0,,,,,,,,,,,,,,,,,,41000000.0,-8000000.0,,,0.0,,-3000000.0,,,,,,,,1000000.0,350000000.0,,,,7000000.0,70000000.0,,,,,,,,,,,,,402000000.0,,,,,0.07,0.22,0.07,0.556,0.34,0.21,,118000000.0,143000000.0,,,,,,,,39000000.0,,,,,,,,,,,,,,,,,,,,,,,,,,,,,,,,,,,,182000000.0,,152000000.0,-12000000.0,-92000000.0,201000000.0,40000000.0,,,,,,,679000000.0,154000000.0,8000000.0,,1283000000.0,0.29,0.71,0.71,5000000.0,0.0,0.03,0.13,0.13,-1000000.0,,35000000.0,,-91000000.0,,,23000000.0,,,2000000.0,240000000.0,-11000000.0,,,5000000.0,,,,,,,-47000000.0,,,,20000000.0,65000000.0,72000000.0,,,-103000000.0,,12000000.0,,-22000000.0,3810000.0,,,,104000000.0,,,74000000.0,,,578000000.0,,,,,183000000.0,,,,,,,,,,,,,,,,,8815000000.0,13429000000.0,852000000.0,,666000000.0,,,,1500000000.0,,230000000.0,,,4891000000.0,343000000.0,7419000000.0,,,,,,,4891000000.0,,,,0.0,,,,2000000.0,,,150000000.0,178000000.0,-370000000.0,2000000.0,497000000.0,,,,,,511000000.0,,4000000.0,-269000000.0,,,,,,,,,,,,,,,,,,,111000000,,,,,302000000.0,,0.0,,25000000.0,,,22000000.0,,-6000000.0,,,19000000.0,25000000.0,-72000000.0,26000000.0,,129000000.0,,,,,,,225000000.0,,,,,241000000.0,,,-17000000.0,,190000000.0,6000000.0,,,3000000.0,0.0,20000000.0,,,,,,,,,,,8000000.0,1249000000.0,,,47000000.0,,10000000.0,,,,,95000000,,,,,,,,0.0,0.0,0.0,1100000000.0,0.0,,0.0,-2000000.0,362000000.0,0.0,,,,,,,,-5000000.0,268000000.0,,2524000000,,,,539000000.0,-39000000.0,-24000000.0,,,,,,,,,,,302000000.0,,0.0,362000000.0,615000000.0,365000.0,,,10000000.0,,,,52000000.0,181000000.0,1872000000.0,1569000000.0,174000000.0,,,4073000000.0,,,1748000000.0,,64000000.0,145000000.0,1000000.0,,,,,,,,,,,,,,,,,,,,,1784340.0,,,,,,,,,,4612000000.0,4614000000.0,,,,,,,,0.0,,,,,6530000000.0,,,11000000.0,,,,,,,,,,,,,,,,,,211357000.0,211357000.0,,,,,,,,1
14,343000000,,37000000.0,,,,,34000000.0,,,576000000,47000000.0,6378000000,4000000.0,411000000.0,-791000000.0,,,,3000000.0,,3000000.0,,,,13429000000.0,2517000000.0,,0.0,,,0.0,,,,,,,,,,,,,,,,,,7371000000.0,,,,,,,,,,,,,1656000000.0,780000000.0,-23000000.0,,701000000.0,,2356000000.0,196000000.0,,,1360000000.0,535975518.0,211557320.0,,,,4000000.0,,,238000000.0,,171000000.0,,,1322000000.0,1343000000.0,5975000000.0,-26000000.0,3000000.0,13000000.0,,39000000.0,5500000000.0,,,28000000.0,,,,,178000000.0,12000000.0,17000000.0,-6000000.0,303000000.0,24000000.0,82000000.0,6000000.0,620000000.0,,557000000.0,218000000.0,2000000.0,18000000.0,152000000.0,56000000.0,,,,75000000.0,37000000.0,,,63000000.0,,196000000.0,19000000.0,,154000000.0,5200000000.0,,,1.0,,,,,,,,,,,,11000000.0,,,,,,,,,,,,17000000.0,,,5900000000.0,4600000000.0,5900000000.0,,,,,,3000000.0,,,21000000.0,,206000000.0,480000000.0,,,,,,,72000000.0,,0.04,0.21,,,,,,,,,,,,,,,,2000000.0,,,49000000.0,,,,,,,,,,,,,,,0.26,,0.125,0.24,0.21,,118000000.0,168000000.0,,4000000.0,8000000.0,,,,,37000000.0,,,,,,,,,,,,10000000.0,,,,,,,,,,,,,,,,,,7000000.0,0.0,,4000000.0,,,,78000000.0,,,0.0,108000000.0,40000000.0,,267000000.0,,16000000.0,,,421000000.0,,82000000.0,,1274000000.0,0.17,,,6000000.0,52000000.0,0.08,,,-2000000.0,,,,,,28000000.0,12000000.0,,,0.0,176000000.0,-2000000.0,,0.0,1000000.0,0.0,,,158000000.0,,,-65000000.0,,10000000.0,65000000.0,27000000.0,62000000.0,37000000.0,-12000000.0,,,-5000000.0,7000000.0,115000000.0,,,,11000000.0,,95000000.0,5.0,224000000.0,103000000.0,,120000000.0,595000000.0,,,,,176000000.0,,0.0,,,,,,,,,,,,,36000000.0,,8815000000.0,13429000000.0,919000000.0,,578000000.0,,,,,,230000000.0,,,4891000000.0,668000000.0,6943000000.0,,,,,,,4891000000.0,,,,20000000.0,,0.0,,,4000000.0,-653000000.0,197000000.0,433000000.0,,,157000000.0,,0.0,,9301000000.0,,511000000.0,,1000000.0,,,,,,,,,,,,,,,,24000000.0,,,,106000000,2000000.0,,,,229000000.0,,,,,8000000.0,,2000000.0,,,,1000000.0,24000000.0,27000000.0,2000000.0,,171000000.0,94000000.0,-379000000.0,,,,,0.0,88000000.0,,,,,241000000.0,1000000.0,,,-2000000.0,,8000000.0,,21000000.0,9000000.0,,21000000.0,,,21000000.0,563000000.0,11000000.0,,0.0,78000000.0,,,,1166000000.0,145000000.0,-11000000.0,47000000.0,,,,,,,82000000,,362000000.0,,,,,,23000000.0,,,1044000000.0,,425000000.0,,-6000000.0,362000000.0,,-4000000.0,,28000000.0,145000000.0,47000000.0,34000000.0,,-568000000.0,483000000.0,5445000000.0,2557000000,,,,537000000.0,-80000000.0,-52000000.0,,,,,,,,0.0,614000000.0,,,7000000.0,,362000000.0,615000000.0,,,7000000.0,10000000.0,,,,,181000000.0,7196000000.0,1652000000.0,179000000.0,,,,,,1704000000.0,,54000000.0,,0.0,6000000.0,12000000.0,,,,,,,,,,,,,,,,,,,1033647.0,,,,,,,,,,4612000000.0,4614000000.0,,,,,,,,,,,,,,,,,,,,,,,2000000.0,2000000.0,,,,,,,,,,,,,,,,,,,1
15,344000000,589000000.0,,,,,,37000000.0,,,554000000,46000000.0,6361000000,4000000.0,411000000.0,-791000000.0,4552000000.0,8222000000.0,,3000000.0,,,45000000.0,,,13429000000.0,2502000000.0,,0.0,,,,,,,,,,,,,,,,,,,,,8646000000.0,,,,,,,,,,,,,1746000000.0,908000000.0,,139000000.0,,,,,0.05,,1360000000.0,535975518.0,211358955.0,,,674000000.0,,238000000.0,0.0,104000000.0,,231000000.0,,,,,1335000000.0,,,,7000000.0,43000000.0,,,,,,,,,,,17000000.0,,,24000000.0,68000000.0,,,,,,0.0,,70000000.0,,,,,,,,,,,259000000.0,,,,,,,226000000.0,,,,,,,,,,,,11000000.0,,,,,,,,,,,,44000000.0,,,,,,,,,,,-3000000.0,,,,,,476000000.0,,,,,,-16000000.0,36000000.0,,,0.0,-5000000.0,,,,,,,,,1283000000.0,,,,29000000.0,254000000.0,,,,,,,,,,,,,83000000.0,,,,,4.49,,4.48,,0.25,0.21,,139000000.0,187000000.0,,,,,,,,36000000.0,,,,,,,,,,,,,,,,,,,,,,,,,,,,,,,-10000000.0,,,,,,16000000.0,0.0,,0.0,96000000.0,40000000.0,,,,5000000.0,,,326000000.0,173000000.0,27000000.0,,,0.08,0.59,0.58,9000000.0,0.0,0.05,0.0,0.0,-6000000.0,,-274000000.0,,-54000000.0,,,14000000.0,,,4000000.0,123000000.0,,,,-5000000.0,,,,,,,-53000000.0,,,,-1000000.0,25000000.0,58000000.0,,,0.0,,,,,4457000.0,,,,452000000.0,5000000.0,273000000.0,73000000.0,,118000000.0,595000000.0,,,,,174000000.0,,,,,,,,,,,,,,,,,8815000000.0,13429000000.0,898000000.0,,0.0,,,,,,230000000.0,,,4891000000.0,62000000.0,6943000000.0,,,,,,,4891000000.0,,,,0.0,,,,2000000.0,,-604000000.0,214000000.0,367000000.0,0.0,2000000.0,157000000.0,,0.0,,9374000000.0,,511000000.0,,1000000.0,123000000.0,,,,,,,,,,,,,,,,,,,102000000,,,,,409000000.0,,3000000.0,,225000000.0,,,-18000000.0,,26000000.0,,,22000000.0,24000000.0,,2000000.0,,136000000.0,28000000.0,,,,,,174000000.0,,,,,311000000.0,,,-6000000.0,,-3000000.0,,,,11000000.0,24000000.0,,,,,,,,0.0,,,,10000000.0,1106000000.0,,,46000000.0,,23000000.0,,,,,87000000,,,,,,,,23000000.0,0.0,0.0,,,,0.0,-3000000.0,362000000.0,0.0,,,2000000.0,,,,,,365000000.0,,2484000000,,,,545000000.0,-120000000.0,-78000000.0,,,,,,,,,565000000.0,,302000000.0,,,362000000.0,615000000.0,,,3000000.0,10000000.0,,,,41000000.0,181000000.0,,6216000000.0,0.0,,,1407000000.0,,,3663000000.0,,31000000.0,452000000.0,0.0,,,,,,,,,,,,,,,,,,,,,1516957.0,,,,,,,,,,4612000000.0,,,,,,,,,,,,,,6552000000.0,,,,,,,,,,,,,,,,,,,,,211342000.0,211342000.0,,,,,,,,1
16,326000000,702000000.0,34000000.0,,,,,17000000.0,,,549000000,30000000.0,6294000000,,,,4552000000.0,8258000000.0,,1000000.0,,5000000.0,45000000.0,,,13429000000.0,2174000000.0,,0.0,,,0.0,,,,,,,,,,,,,,,,,,,,,,,,,,,,,,,,,-501000000.0,139000000.0,356000000.0,,,,,,1360000000.0,,535935395.0,,,673000000.0,,,,402000000.0,,144000000.0,,,2712000000.0,3803000000.0,2976000000.0,-49000000.0,,,-1000000.0,31000000.0,5125000000.0,,,26000000.0,,,,,107000000.0,3000000.0,,7000000.0,,,28000000.0,0.0,387000000.0,,326000000.0,,254000000.0,19000000.0,83000000.0,51000000.0,,,,,,,,61000000.0,,0.0,41000000.0,,197000000.0,4200000000.0,,,,,,,,,,,,,,,,,,,,,,,,,,,16000000.0,,,4400000000.0,4100000000.0,4500000000.0,,,,,,,,,,,197000000.0,,,,,,,,21000000.0,,0.22,0.12,,,,,,,,,,,,,,,,5000000.0,,,172000000.0,,,,,,,,,,,,,,,0.31,,0.031,0.25,0.21,,117000000.0,204000000.0,,5000000.0,12000000.0,,,,,37000000.0,,,,,,,,,,,,4000000.0,,,,,,,,,,,,,,,,,,-2000000.0,-4000000.0,,14000000.0,,,32000000.0,,,-16000000.0,,338000000.0,40000000.0,,798000000.0,,19000000.0,,,,,,,98000000.0,0.25,0.33,0.33,4000000.0,19000000.0,0.0,1.79,1.78,-13000000.0,,,,,,,30000000.0,,,,,,,,,-2000000.0,,,,,,-75000000.0,,11000000.0,,19000000.0,75000000.0,37000000.0,-27000000.0,,,4000000.0,4000000.0,103000000.0,0.0,,,38000000.0,,,11.0,356000000.0,104000000.0,,120000000.0,595000000.0,,,,,0.0,,74000000.0,,,,,,,,,,,,,34000000.0,,,,875000000.0,,0.0,,,,,,,,,4891000000.0,62000000.0,6943000000.0,,,,,,,4891000000.0,,,,,,0.0,,2000000.0,4000000.0,-1230000000.0,178000000.0,551000000.0,-545000000.0,2000000.0,,,,,,,511000000.0,,1000000.0,,,,,,,,,,,,,,,,31000000.0,,,,83000000,1000000.0,,,,424000000.0,,,,,30000000.0,,-40000000.0,,,,0.0,-559000000.0,-352000000.0,,,5000000.0,7000000.0,,0.0,,,,,302000000.0,,,,,285000000.0,1000000.0,,,15000000.0,,2000000.0,,28000000.0,5000000.0,,,,,581000000.0,,22000000.0,,,115000000.0,,,,987000000.0,,-19000000.0,44000000.0,,,,,,,77000000,,,,,,,,1000000.0,,,,,,,-5000000.0,362000000.0,,,,,145000000.0,47000000.0,37000000.0,,,,5649000000.0,2586000000,,,,276000000.0,-162000000.0,-105000000.0,,,,,,,,,617000000.0,,,21000000.0,,362000000.0,615000000.0,,,6000000.0,,,,,,,1823000000.0,1494000000.0,210000000.0,,,1407000000.0,,,1959000000.0,,161000000.0,,,25000000.0,16000000.0,,,,,,,,,,,,,,,,,,,3034349.0,,,,,,,,,,,,,,,,,,,6063000.0,,,,,6531000000.0,,,6000000.0,,,,,,,1000000.0,1000000.0,,,,,,,,,,,,,,,,,,,1
17,326000000,497000000.0,,,,,,17000000.0,,,545000000,30000000.0,6294000000,5000000.0,422000000.0,-756000000.0,4597000000.0,8242000000.0,,1000000.0,,,41000000.0,,,13429000000.0,2174000000.0,,0.0,,,,,,,,,,,,,,,,,,,,,,,,,,,,,,,,,,1628000000.0,1620000000.0,,139000000.0,,,,,0.05,1.25,,538408104.0,535975518.0,,,671000000.0,,104000000.0,0.0,164000000.0,,144000000.0,,,,,1641000000.0,3000000.0,-5000000.0,92000000.0,-2000000.0,31000000.0,,,,,,,,,-30000000.0,28000000.0,15000000.0,,,26000000.0,28000000.0,2000000.0,,,,,254000000.0,,96000000.0,,,,,,,,,,,86000000.0,,,,,,,1.0,,,,,,,,,,,,,,,,,,,,,,,,44000000.0,,,,,,,,,,,0.0,,,27000000.0,,,113000000.0,,,,,,,72000000.0,,0.0,,,,,,,,,,4000000.0,,,,,,,,,,,,,,,,,,,402000000.0,,,,,3.52,,3.5,-0.299,0.205,0.21,,117000000.0,204000000.0,,,,,,,,48000000.0,,,,,,,,,,,,,,,,,,,,,,,,,,,,,,,4000000.0,,,,,,21000000.0,152000000.0,,0.0,299000000.0,,,,,,,,353000000.0,19000000.0,151000000.0,,121000000.0,0.16,0.83,0.82,9000000.0,,0.0,,,-18000000.0,,-249000000.0,,,,-10000000.0,30000000.0,,,-4000000.0,177000000.0,-6000000.0,,24000000.0,-3000000.0,,,,99000000.0,,,-72000000.0,,,120000000.0,-7000000.0,32000000.0,23000000.0,,,-103000000.0,,8000000.0,,0.0,3841000.0,,,,,11000000.0,406000000.0,104000000.0,,124000000.0,595000000.0,,,,,0.0,,56000000.0,,,,,,,,,,,,,,,8876000000.0,13580000000.0,875000000.0,,19000000.0,,,,,,550000000.0,,,4787000000.0,62000000.0,6943000000.0,,,,,,,4875000000.0,,,,0.0,,,,2000000.0,,-1180000000.0,215000000.0,464000000.0,,2000000.0,540000000.0,,0.0,,16433000000.0,,,,,123000000.0,,,,,,,,,,,,,,,37000000.0,,,,79000000,,,,,317000000.0,,,,,,,,,,,,,,,,,,50000000.0,,,,,,139000000.0,,,,,285000000.0,,,-35000000.0,,212000000.0,3000000.0,,,-3000000.0,37000000.0,,,,,152000000.0,,,0.0,,,,10000000.0,987000000.0,37000000.0,,44000000.0,,,,,,14000000.0,77000000,,0.0,,,,,,,,,887000000.0,,245000000.0,,-2000000.0,,,0.0,,6000000.0,,,,,-181000000.0,425000000.0,,2572000000,,,,276000000.0,,,,,,,,,,425000000.0,567000000.0,,,,,,,,,8000000.0,4000000.0,,,,83000000.0,187000000.0,1865000000.0,3287000000.0,376000000.0,,,,,,5615000000.0,,96000000.0,135000000.0,,,,,,,,,,,,,,,,,,,,,,2900000.0,,,,,,,,,,4702000000.0,4614000000.0,,,,,,,,,,,,,6507000000.0,,,,,,,,,,,,,,,,,,,,,,,,,,,,,,1
18,204000000,507000000.0,48000000.0,,,,,17000000.0,,,427000000,30000000.0,3291000000,4000000.0,410000000.0,-662000000.0,4607000000.0,8181000000.0,,1000000.0,,2000000.0,40000000.0,,,,3639000000.0,,,,,,,,,,,,,,,,,,,,,,,,,,,,,,,,,,,,,,-402000000.0,139000000.0,,,,,0.6,1.25,,538639584.0,535975518.0,,,671000000.0,,,,-57000000.0,,144000000.0,,,1390000000.0,1283000000.0,4473000000.0,7000000.0,,,,31000000.0,5093000000.0,,,37000000.0,,,,,-69000000.0,14000000.0,11000000.0,22000000.0,,42000000.0,28000000.0,-3000000.0,465000000.0,,401000000.0,,254000000.0,28000000.0,101000000.0,53000000.0,,,,,,,,64000000.0,,86000000.0,37000000.0,,224000000.0,,,,27000000.0,,,,,,,,,,,,,,,,,,,,,,,,44000000.0,,,3300000000.0,2800000000.0,,,,,,,,,,,,,,,,,,,117000000.0,,,0.11,0.18,45000000.0,,,,,,,,7000000.0,,,,,,,,,,,,,,,,,,,,,,,,3.52,0.17,3.5,-0.534,,0.21,,117000000.0,204000000.0,,,,,,,,47000000.0,,,,,,,,,,,,,,,,,,,,,,,,,,,,,,-9000000.0,8000000.0,,6000000.0,,,,,,,,112000000.0,,,286000000.0,,2000000.0,,,,19000000.0,,,,0.21,0.23,0.23,,111000000.0,,0.0,0.0,0.0,,38000000.0,,-15000000.0,,,30000000.0,,,,,,,,,,,,,,,-116000000.0,,18000000.0,,37000000.0,30000000.0,-68000000.0,6000000.0,,,,-2000000.0,67000000.0,0.0,,,15000000.0,,93000000.0,16000000.0,413000000.0,102000000.0,,124000000.0,,,,,,74000000.0,,,,,,,,,,,,,,,34000000.0,,8303000000.0,13039000000.0,1325000000.0,,,,,,,,0.0,,,6610000000.0,62000000.0,,,,,,,,4787000000.0,,,,,,0.0,,2000000.0,,-1289000000.0,143000000.0,744000000.0,,,,,,,,,,,,-447000000.0,,,,,,,,,,,,,,,,,,,58000000,1000000.0,,,,224000000.0,,-1000000.0,,44000000.0,6000000.0,,,,-42000000.0,,0.0,1000000.0,-5000000.0,,-17000000.0,29000000.0,,,,,,,,2000000.0,,,,,269000000.0,1000000.0,,,3000000.0,,2000000.0,,32000000.0,-23000000.0,,,,,11000000.0,,44000000.0,,,194000000.0,,,,987000000.0,,-21000000.0,44000000.0,,11000000.0,,,,14000000.0,63000000,,0.0,,,,,,,,,0.0,,,,-1000000.0,,,0.0,,,145000000.0,49000000.0,37000000.0,,-18000000.0,,5881000000.0,1233000000,,,,276000000.0,-56000000.0,-36000000.0,,,,,,,,,682000000.0,,,7000000.0,,,,,,,3000000.0,,,,,116000000.0,1865000000.0,1793000000.0,166000000.0,,,5528000000.0,,,1952000000.0,,56000000.0,,,2000000.0,24000000.0,,,,,,,,,,,,,,,,,,,4200000.0,,,,,,,,,,4734000000.0,4614000000.0,,,,,,,,,,,,,6552000000.0,,,,,,,,,,,,,,,,,,,,,211440000.0,211440000.0,,,,,,,,1
19,204000000,507000000.0,,,,,,24000000.0,,,427000000,46000000.0,3287000000,4000000.0,436000000.0,-655000000.0,4587000000.0,8181000000.0,,,,117000000.0,,,,13464000000.0,3639000000.0,,,,,,,,,,,,,,,,,,,,,,,,,,,,,,,,,,,,1869000000.0,1580000000.0,,,521000000.0,,,,,1.25,1360000000.0,537210159.0,535975518.0,,,671000000.0,,402000000.0,,,,195000000.0,,,,,1497000000.0,,,,1000000.0,46000000.0,,,,,,,,,,,10000000.0,69000000.0,,28000000.0,52000000.0,,,,,,4000000.0,,,,,,,,,,,,,71000000.0,,,,,,,1.0,,,,,,,,,,,,,,,,,,,,,,,,16000000.0,,,,,,,,,,,0.0,,,21000000.0,,,226000000.0,,,,,,23000000.0,26000000.0,,,,8000000.0,,,,,,,,,,,,,,,,,,,,,,,,,,,,,,,,,,,,,,,150000000.0,204000000.0,,,,,,,,46000000.0,,,,,,,,,,,,,,,,,,,,,,,,,,,,,,,,,,,,,30000000.0,,-9000000.0,0.0,98000000.0,,,,,3000000.0,,,,,,,23000000.0,0.24,0.82,0.82,1000000.0,0.0,,,,,,,,2000000.0,,-15000000.0,30000000.0,,,,,,,,,,,,,,,-53000000.0,,,236000000.0,,,-43000000.0,-10000000.0,,0.0,2000000.0,-6000000.0,,,,,,,,,463000000.0,102000000.0,,67000000.0,645000000.0,,,,,74000000.0,,31000000.0,,,,,,,,,,,,,,,8036000000.0,12835000000.0,1325000000.0,,,,,,,,0.0,,,6610000000.0,,6638000000.0,,,,,,,4787000000.0,,,,,,,,4000000.0,,-1255000000.0,164000000.0,689000000.0,-175000000.0,0.0,,,,,,,,,,,,,,,,,,,,,,,,,,,,,58000000,,,,,224000000.0,,,,,,,,,,,,30000000.0,16000000.0,,,,,22000000.0,,,,,,-11000000.0,,,,,269000000.0,,,,,,3000000.0,,,14000000.0,,,,,,301000000.0,,,,,,,0.0,987000000.0,69000000.0,,44000000.0,,,,,,14000000.0,63000000,,0.0,,,,,,,,,0.0,,385000000.0,,,,,0.0,,7000000.0,,,,,-18000000.0,,,1233000000,,,,487000000.0,-99000000.0,-64000000.0,,,,,,,,670000000.0,632000000.0,,,,,,,,,2000000.0,2000000.0,,,,,192000000.0,,5059000000.0,556000000.0,,,,,,,,32000000.0,601000000.0,,,,,,,,,,,,,,,,,,,,,,4500000.0,,,,,,,,,,4795000000.0,4704000000.0,,,,,,,,16190000.0,,,,,6479000000.0,,,6000000.0,,,,,,,,,,,,,,,,,,,,,,,,,,,1
20,204000000,507000000.0,62000000.0,,,,,24000000.0,,,427000000,46000000.0,3287000000,4000000.0,413000000.0,-1179000000.0,4595000000.0,8181000000.0,,3000000.0,,,38000000.0,,,13580000000.0,3639000000.0,,,,,,,,,,,,,,,,,,,,,,,,,,,,,,,,,,,,1869000000.0,,,,,,,,,1.25,1360000000.0,536425400.0,535975518.0,,,671000000.0,,,-1000000.0,5000000.0,,195000000.0,,,4111000000.0,5120000000.0,,1000000.0,11000000.0,-13000000.0,,46000000.0,,,,,,,,,37000000.0,42000000.0,8000000.0,109000000.0,,46000000.0,52000000.0,-3000000.0,429000000.0,,363000000.0,,4000000.0,16000000.0,107000000.0,48000000.0,,,,,,,,66000000.0,,0.0,28000000.0,,239000000.0,,,,,,,,,,,,,,,,,,,,,,,,,,,,16000000.0,,,3000000000.0,2300000000.0,,,,,,,,,,,,,,,,,,,19000000.0,,,0.18,0.18,6000000.0,,,,,,,,10000000.0,,,,,,,,,,,,,,,,,,,1070000000.0,,,,,,0.43,,0.183,,,,150000000.0,,,,,,,,,72000000.0,,,,,,,,,,,,,,,,,,,,,,,,,,,,,,8000000.0,,,17000000.0,,,32000000.0,,0.0,,-276000000.0,455000000.0,,,1096000000.0,,1000000.0,,,643000000.0,,73000000.0,,,0.03,,,-12000000.0,59000000.0,,,,-105000000.0,,45000000.0,,17000000.0,,,,,,54000000.0,250000000.0,-20000000.0,,-22000000.0,-2000000.0,,,,198000000.0,,,,,,,14000000.0,,,,,0.0,,,,,4082000.0,,52000000.0,,210000000.0,18000000.0,,102000000.0,,67000000.0,603000000.0,,,,,1011000000.0,,,,,,,,,,,,,,,,,8331000000.0,12598000000.0,1325000000.0,,,,,,,,0.0,,,6610000000.0,,6529000000.0,,,,,,,4787000000.0,,,,0.0,,,,4000000.0,,,,,-20000000.0,,43000000.0,,,,15145000000.0,,,,,-379000000.0,,,,,,,,,,,,,,,39000000.0,,,,58000000,,,,,224000000.0,,-2000000.0,,67000000.0,22000000.0,,,,-25000000.0,,0.0,35000000.0,26000000.0,,-47000000.0,81000000.0,,,0.0,,,,,1000000.0,,,,,269000000.0,,,-4000000.0,7000000.0,66000000.0,0.0,,,,0.0,,,,608000000.0,,,,,,,,0.0,,,,,,22000000.0,,,,14000000.0,63000000,,0.0,,,,,,,,,,,,,,,,,,,526000000.0,,38000000.0,,,419000000.0,,1233000000,,,,487000000.0,-148000000.0,-96000000.0,,,,,,,,,,,,30000000.0,,,,,,3000000.0,5000000.0,,,,12000000.0,176000000.0,3930000000.0,1772000000.0,180000000.0,,,5068000000.0,,,,,220000000.0,150000000.0,,27000000.0,,,,,,,,,,,,,,,,,,,,1500000.0,,,,,,,,,,4263000000.0,4736000000.0,,,,,,,,,,,,,6479000000.0,,,,,,,,,,,,,,,,,,,,,211521000.0,211521000.0,,,,,,,,1
21,385000000,507000000.0,,,,,,36000000.0,,,595000000,52000000.0,6371000000,,,-1179000000.0,4595000000.0,8181000000.0,,4000000.0,,114000000.0,38000000.0,,,13039000000.0,1830000000.0,,,,,,,,,,,,,,,,,,,,,,,,,,,,,,,,,,,,1869000000.0,1577000000.0,-4000000.0,,1282000000.0,,,,,,1360000000.0,536425400.0,535976000.0,,,,,164000000.0,,,,223000000.0,,,,,,,,,,34000000.0,,,,,,,,,,,8000000.0,,,46000000.0,37000000.0,,,,,,15000000.0,,78000000.0,,,,,,,,,,,,,,,,,,,,,,,,,,,,,,,,,,,,,,,,,,25000000.0,,,,,,,,,,,0.0,,,22000000.0,,,338000000.0,,,,,,56000000.0,-6000000.0,,,,20000000.0,,,,,,,,,,,,,,,,,,,,,,,,,,,463000000.0,,,,,4.0,0.26,3.99,,,,,150000000.0,150000000.0,,,,,,,,69000000.0,,,,,,,,,,,,,,,,,,,,,,,,,,,,,,,7000000.0,,,,,,38000000.0,0.0,,,404000000.0,40000000.0,,,,4000000.0,,,,202000000.0,,,254000000.0,,0.95,0.95,,,,,,3000000.0,,42000000.0,,15000000.0,,-14000000.0,25000000.0,,,,,-22000000.0,,,,,,,,,,-78000000.0,,-12000000.0,93000000.0,2000000.0,66000000.0,33000000.0,3000000.0,,,1000000.0,10000000.0,59000000.0,0.0,,,,,,,156000000.0,100000000.0,,67000000.0,590000000.0,,,,,905000000.0,,,,,,,,,,,,,,,,,8331000000.0,12598000000.0,984000000.0,,,,,,,,0.0,,,6610000000.0,0.0,6467000000.0,,,,,,,7803000000.0,,,,,,,,,,-46000000.0,151000000.0,-109000000.0,-20000000.0,-1000000.0,,,,,,,511000000.0,,,-178000000.0,,,,,,,,,,,,,,,,,,,107000000,,,,,224000000.0,,,,,,,,,,,,-306000000.0,-234000000.0,,,52000000.0,,95000000.0,,,,,,3000000.0,,,,,269000000.0,,,,25000000.0,,4000000.0,,14000000.0,-5000000.0,0.0,,,,,460000000.0,11000000.0,,,35000000.0,,,0.0,983000000.0,104000000.0,24000000.0,79000000.0,,,,,,,135000000,,,,,,,,,,,,,875000000.0,,0.0,,,0.0,,19000000.0,,0.0,,,,,,2763000000,,,,578000000.0,-199000000.0,-131000000.0,,,,,,,,860000000.0,2000000.0,,,,,0.0,615000000.0,,,2000000.0,5000000.0,,,,,176000000.0,2065000000.0,7059000000.0,0.0,,,1455000000.0,,,,,125000000.0,292000000.0,,,14000000.0,,,,,,,,,,,,,,,,,,,2400000.0,,,,,,,,,,4263000000.0,4799000000.0,,,,,,,,,,,,,6480000000.0,,,,,,,,,,,,,,,,,,,,,,,,,,,,,,1
22,300000000,,61000000.0,,,,,33000000.0,,,590000000,34000000.0,3334000000,,,-1179000000.0,4595000000.0,,,2000000.0,,1000000.0,34000000.0,,,12835000000.0,3328000000.0,,,,,,,,,,,,,,,,,,,,,,,,,,,,,,,,,,,,1869000000.0,1580000000.0,,,,,,,0.05,,1360000000.0,536425400.0,,,,,,,,,,172000000.0,,,1399000000.0,,,,,,0.0,30000000.0,,,,,,,,,,,8000000.0,73000000.0,,46000000.0,63000000.0,,300000000.0,,250000000.0,,250000000.0,,70000000.0,42000000.0,,,,,,,,50000000.0,,0.0,21000000.0,,258000000.0,,,,,,,,,,,,,,,,,,,,,,,,,,,,25000000.0,,,2800000000.0,2500000000.0,,,,,,,,,,,,,,,,,,,33000000.0,,,0.08,0.09,12000000.0,,,,,,,,0.0,,,,,,,,,,,,,,,,,,,267000000.0,,,,,,0.11,,0.103,,,,130000000.0,185000000.0,,,,,,,,67000000.0,,,,,,,,,,,,,,,,,,,,,,,,,,,,,,10000000.0,,,,,,0.0,,,-5000000.0,-276000000.0,,40000000.0,,,,1000000.0,,,,,,,,,0.73,0.73,-13000000.0,95000000.0,,,,,,7000000.0,,13000000.0,,,7000000.0,,,,,-24000000.0,,,,,,,,,,-38000000.0,,,,,,10000000.0,-19000000.0,,0.0,,,,,3951000.0,,48000000.0,,117000000.0,,,126000000.0,,123000000.0,568000000.0,,,,,73000000.0,,,,,,,,,,,,,,,,,8331000000.0,12598000000.0,1557000000.0,,,,,,,,,,,,0.0,6221000000.0,,,,,,,8013000000.0,,,,,,,,4000000.0,,-68000000.0,,-87000000.0,,,183000000.0,,,,14998000000.0,,511000000.0,,,84000000.0,,,,,,,,,,,,,,,47000000.0,,,,86000000,,,,,,,-1000000.0,,23000000.0,,,,,17000000.0,,,-5000000.0,,,-30000000.0,61000000.0,,,,,,,,,,,,,,,,-12000000.0,,119000000.0,,,,,,,,,,,,,,,,,0.0,926000000.0,,,88000000.0,,11000000.0,,,,,132000000,,0.0,,,,,,,,,0.0,,,,-19000000.0,,,,,,,0.0,,,-4000000.0,,,1462000000,,,,409000000.0,-62000000.0,,,,,,,,,,,,,,,0.0,615000000.0,,,3000000.0,5000000.0,,,,16000000.0,176000000.0,2065000000.0,,,,,1419000000.0,,,,,,142000000.0,,0.0,,,,,,,,,,,,,,,,,,,,2600000.0,,,,,,,,,,4263000000.0,4267000000.0,,,,,,,,67817000.0,,,,,6480000000.0,,,4000000.0,,,,,,,,,,,,,,,,,,212103000.0,211600000.0,,,,,,,,1
23,234000000,745000000.0,,,,,,37000000.0,,,533000000,35000000.0,3364000000,,,-1179000000.0,4595000000.0,8076000000.0,,2000000.0,,,34000000.0,,,12598000000.0,3356000000.0,,,,,,,,,,,,,,,,,,,,,,,,,,,,,,,,,,,,,1580000000.0,-586000000.0,,1951000000.0,,,,0.05,,,536425400.0,,,,672000000.0,,-57000000.0,0.0,1435000000.0,,202000000.0,,,,1290000000.0,,10000000.0,82000000.0,32000000.0,,37000000.0,,,,,,,,,61000000.0,-1000000.0,,26000000.0,,46000000.0,54000000.0,-18000000.0,,,,,122000000.0,,60000000.0,,,,,,,,,,,,,,,,,,,,,,,,,,,,,,,,,,,,,,,,,,,,,,,,,,,,,,,,25000000.0,,,456000000.0,,,,,,114000000.0,26000000.0,,0.05,,42000000.0,,,,,,,,,,,,,,,,,,,,,,,,,,,787000000.0,,,,,,,,-0.005,,,,140000000.0,207000000.0,,,,,,,,62000000.0,,,,,,,,,,,,,,,,,,,,,,,,,,,,,,,8000000.0,,1000000.0,,,,41000000.0,0.0,-11000000.0,0.0,101000000.0,40000000.0,,204000000.0,,15000000.0,,,556000000.0,29000000.0,251000000.0,,133000000.0,,,,,,,,,9000000.0,,4000000.0,,55000000.0,,-13000000.0,5000000.0,,,15000000.0,170000000.0,2000000.0,,0.0,8000000.0,,,,116000000.0,,,-75000000.0,,-8000000.0,99000000.0,-16000000.0,31000000.0,22000000.0,-18000000.0,,,21000000.0,14000000.0,69000000.0,,,,11000000.0,,,5000000.0,247000000.0,89000000.0,,68000000.0,568000000.0,,,,,56000000.0,,,,,,,,,,,,,,,,,8331000000.0,12598000000.0,3327000000.0,,,,,,,,,,,6606000000.0,0.0,,,,,,,,6329000000.0,,,,,,,,4000000.0,,-691000000.0,98000000.0,7000000.0,,,183000000.0,,,,,,511000000.0,,,84000000.0,,,,,,,,,,,,,,,,,,,91000000,,,,,229000000.0,,,,,7000000.0,,,,,,,,-7000000.0,,,-20000000.0,,45000000.0,1000000.0,,,,,14000000.0,,,,,281000000.0,,,,11000000.0,,9000000.0,,25000000.0,5000000.0,,,,,81000000.0,619000000.0,22000000.0,,,74000000.0,,,0.0,875000000.0,137000000.0,43000000.0,50000000.0,,,,,,,150000000,,,,,,,,,,,0.0,,1095000000.0,,,,,,,70000000.0,0.0,0.0,5000000.0,,,427000000.0,,1476000000,,,,412000000.0,,45000000.0,,,,,,,,1290000000.0,550000000.0,,0.0,7000000.0,,0.0,615000000.0,,,0.0,5000000.0,,,,,176000000.0,,,,,,1419000000.0,,,,,49000000.0,448000000.0,,0.0,17000000.0,,,,,,,,,,,,,,,,,,,725000.0,,,,,,,,,,4263000000.0,,,,,,,,,,,,,,14548000000.0,,,,,,,,,,,,,,,,,,,,,,,,,,,,,,1
24,233000000,547000000.0,57000000.0,,,,,20000000.0,,,691000000,33000000.0,3306000000,,,,,7954000000.0,,1000000.0,,12000000.0,29000000.0,,,12598000000.0,1622000000.0,,,,,,,,,,,,,,,,,,,,,,,,,,,,,,,,,,,,,,,,,,,,,,,,538408104.0,,,672000000.0,,,,,,213000000.0,,,5412000000.0,,,,,,,39000000.0,,,,,,,,,,,,,,,40000000.0,,269000000.0,,215000000.0,,293000000.0,,57000000.0,42000000.0,,,,,,,,54000000.0,,43000000.0,19000000.0,,284000000.0,,,,,,,,,,,,,,,,,,,,,,,,,,,,,,,2000000000.0,1800000000.0,,,,,,,,,,,,,,,,,,,,,,0.17,0.84,,,,,,,,,0.0,,,,,,,,,,,,,,,,,,,324000000.0,,,,,0.32,0.33,0.32,-0.164,,,,178000000.0,225000000.0,,,,,,,,61000000.0,,,,,,,,,,,,,,,,,,,,,,,,,,,,,,6000000.0,,,,,,0.0,,,-6000000.0,-276000000.0,88000000.0,40000000.0,,,,0.0,,,,29000000.0,,,,,0.44,0.43,12000000.0,20000000.0,,,,,,-980000000.0,,,,,84000000.0,,,,,3000000.0,,,,,,,,,,-23000000.0,,,,,,-9000000.0,2000000.0,,0.0,,,,-46000000.0,3821000.0,,,,296000000.0,,,120000000.0,,69000000.0,325000000.0,,,,,56000000.0,,,,,,,,,,,,,,,,,8367000000.0,12634000000.0,1206000000.0,,,,,,,,,,,6604000000.0,500000000.0,,,,,,,,6329000000.0,,,,-68000000.0,,,,,,-711000000.0,,27000000.0,-6000000.0,0.0,,,,,14349000000.0,,511000000.0,,,,,,,,,,,,,,,,,,,,,,73000000,,,,,246000000.0,,-2000000.0,,86000000.0,,,,,-14000000.0,,0.0,,135000000.0,,-29000000.0,7000000.0,,,,,,,,,,,,,280000000.0,,,-8000000.0,4000000.0,53000000.0,2000000.0,,,,0.0,,,,,,,,,,,,0.0,1322000000.0,,,49000000.0,,33000000.0,,,,,114000000,,,,,,,,,,,0.0,,,,-23000000.0,,,,,,0.0,,,,14000000.0,,,1562000000,,,,390000000.0,,86000000.0,,,,,,,,,,,0.0,,,0.0,615000000.0,,,5000000.0,,,,,4000000.0,,5840000000.0,,,,,,,,,,28000000.0,156000000.0,,,,,,,,,,,,,,,,,,,,,,863000.0,,,,,,,,,,,4267000000.0,,,,,,,,,,,,,14474000000.0,,,3000000.0,,,,,,,,,,,,,,,,,,247879000.0,247192000.0,,,,,,,,1
25,233000000,425000000.0,,,,,,20000000.0,,,692000000,33000000.0,3306000000,,,,4611000000.0,7824000000.0,,1000000.0,,3000000.0,38000000.0,,,12598000000.0,1622000000.0,,,,,,,,,,,,,,,,,,,,,,,,,,,,,,,,,,,,,1580000000.0,-496000000.0,1458000000.0,1504000000.0,,,,,1.25,,537408938.0,538639584.0,,,676000000.0,,6000000.0,0.0,1119000000.0,,213000000.0,,,,2806000000.0,,,,,-5000000.0,39000000.0,,,,,,,,,,,,49000000.0,,66000000.0,40000000.0,,,,,,293000000.0,,,,,,,,,,,,,,,,,,,,,,,,,,,,,,,,,,,,,,,,,,,,,,,,,,,,,,,,,,,,,444000000.0,,,,,,16000000.0,,,,,6000000.0,,,,,,,,0.0,,,,,,,,,,,,,,,,,,,1275000000.0,,,,,,,,,,,,178000000.0,225000000.0,,,,,,,,62000000.0,,,,,,,,,,,,,,,,,,,,,,,,,,,,,,,1000000.0,,8000000.0,,,,51000000.0,0.0,-17000000.0,0.0,176000000.0,,,481000000.0,,,,,,,,,319000000.0,,,,,58000000.0,,,,18000000.0,,-986000000.0,,,,,84000000.0,,,,,,,0.0,,,,,,,,-106000000.0,,-15000000.0,110000000.0,75000000.0,40000000.0,31000000.0,-26000000.0,,11000000.0,25000000.0,14000000.0,34000000.0,,,,21000000.0,,,10000000.0,362000000.0,120000000.0,,71000000.0,325000000.0,,,,,56000000.0,,,,,,,,,,,,,,,,,8269000000.0,12474000000.0,1206000000.0,,,,,,,,0.0,,,5995000000.0,500000000.0,,,,,,,,6329000000.0,,,,,,,,8000000.0,,-828000000.0,188000000.0,144000000.0,,,,,,,,,,,,85000000.0,,,,,,,,,,,,,,,,,,,74000000,,,,,259000000.0,,,,,45000000.0,,,,,,,,143000000.0,,,,,872000000.0,0.0,,,,,11000000.0,,,,,273000000.0,,,,1000000.0,,3000000.0,,32000000.0,6000000.0,0.0,,,,161000000.0,,22000000.0,,,136000000.0,,,,1322000000.0,,60000000.0,49000000.0,,,,,,14000000.0,114000000,,,,,,,,,,,0.0,,,,,,,,,83000000.0,261000000.0,0.0,7000000.0,,14000000.0,,,1562000000,,,,390000000.0,,129000000.0,,,,,,,,,550000000.0,,,15000000.0,,,,,,,33000000.0,,,,,128000000.0,,,,,,1283000000.0,,,,,55000000.0,,,1000000.0,19000000.0,,,,,,,,,,,,,,,,,,,1000000.0,,,,,,,,,,4197000000.0,4267000000.0,,,,,,,,0.0,,,,,14424000000.0,,,,,,,,,,,,,,,,,,,,,,,,,,,,,,1
26,233000000,357000000.0,63000000.0,,,,,20000000.0,,,692000000,33000000.0,3306000000,,,-1214000000.0,4620000000.0,7691000000.0,,1000000.0,,37000000.0,32000000.0,,,12598000000.0,1622000000.0,,,,,,,,,,,,,,,,,,,,,,,,,,,,,,,,,,,,,,,,,,,,0.1,1.25,,537526343.0,537210159.0,,,678000000.0,,,,,,213000000.0,,,,,,-69000000.0,61000000.0,241000000.0,,39000000.0,,,,,,,,,45000000.0,15000000.0,,,,83000000.0,40000000.0,12000000.0,,,,,293000000.0,,,,,,,,,,,,,6000000.0,,,,,,,,,,,,,,,,,,,,,,,,,,,,,,,,,,,,,,,,,,,,,27000000.0,,,112000000.0,,,,,,43000000.0,,,0.08,,11000000.0,,,,,,,,0.0,,,,,,,,,,,,,,,,,,,,,,,,0.18,0.21,0.18,0.176,,,,178000000.0,225000000.0,,,,,,,,61000000.0,,,,,,,,,,,,,,,,,,,,,,,,,,,,,,,-11000000.0,,,,,,,,-6000000.0,-276000000.0,,,,,,1000000.0,,,-268000000.0,,55000000.0,,,,1.09,1.08,24000000.0,,,,,,,-1025000000.0,,83000000.0,,-2000000.0,84000000.0,,,-2000000.0,-45000000.0,5000000.0,,,-31000000.0,,,,68000000.0,,,-74000000.0,,,,-15000000.0,,5000000.0,,,45000000.0,,,,-25000000.0,3757000.0,,18000000.0,,86000000.0,,,120000000.0,,71000000.0,325000000.0,,,,,56000000.0,,,,,,,,,,,,,,,,,8278000000.0,12475000000.0,1206000000.0,,,,,,,,0.0,,,5992000000.0,500000000.0,,,,,,,,6329000000.0,,,,,,,,11000000.0,,,,,14000000.0,0.0,463000000.0,,,,14221000000.0,,,,,248000000.0,,,,,,,,,,,,,,,,,,,74000000,,,,,285000000.0,,0.0,,19000000.0,,,,,11000000.0,,,,347000000.0,,18000000.0,,,,,,,,,,,,,,276000000.0,,,-28000000.0,-3000000.0,147000000.0,3000000.0,,,,,,,,,241000000.0,,,,,,,0.0,1322000000.0,33000000.0,,49000000.0,,11000000.0,,,,14000000.0,114000000,,,,,,,,,,,,,550000000.0,,-24000000.0,,,,,,,,,,,384000000.0,,1562000000,,,,390000000.0,,-325000000.0,,,,,,,,230000000.0,,,0.0,,,,,,,16000000.0,30000000.0,,,,26000000.0,132000000.0,1910000000.0,,,,,3224000000.0,,,,,,,,,,,,,,,,,,,,,,,,,,,,906000.0,,,,,,,,,,4186000000.0,4267000000.0,,,,,,,,,,,,,14299000000.0,,,,,,,,,,,,,,,,,,,,,318360000.0,317369000.0,,,,,,,,1
27,233000000,357000000.0,,,,,,20000000.0,,,692000000,33000000.0,3306000000,,,-1238000000.0,4692000000.0,7691000000.0,,1000000.0,,,28000000.0,,,12634000000.0,1622000000.0,,,,,,,,,,,,,,,,,,,,,,,,,,,,,,,,,,,,,,-514000000.0,643000000.0,-794000000.0,,,,,1.25,1360000000.0,540671722.0,536425000.0,,,678000000.0,,66000000.0,,,,213000000.0,,,1382000000.0,1516000000.0,,,,,,39000000.0,,,,,,,,,,,,73000000.0,,89000000.0,40000000.0,,,,,,293000000.0,,,,,,,,,,,,,6000000.0,,,,,,,,,,,,,,,,,,,,,,,,,,,,,,,,,,,,,,,,,,,,,,,,,,,,,,,,,,0.0,,,,,,,,,,,,,,,,,,,,,,,,,,,,248000000.0,,,,,0.18,,0.18,,,,,178000000.0,225000000.0,,,,,,,,61000000.0,,,,,,,,,,,,,,,,,,,,,,,,,,,,,,-4000000.0,,,7000000.0,,,,121000000.0,0.0,-23000000.0,0.0,88000000.0,,,277000000.0,,,,,,257000000.0,,,,,,,,38000000.0,,,,22000000.0,,-1028000000.0,,42000000.0,,,84000000.0,,,,,,,,,,,,,,,-133000000.0,,-15000000.0,27000000.0,73000000.0,46000000.0,24000000.0,2000000.0,,,1000000.0,-3000000.0,53000000.0,,,,10000000.0,,,15000000.0,420000000.0,120000000.0,,71000000.0,677000000.0,,,,,33000000.0,,,,,,,,,,,,,,,,,7985000000.0,12338000000.0,1206000000.0,,,,,,,,0.0,,,5992000000.0,,,,,,,,,,,,,,,,,13000000.0,,-927000000.0,122000000.0,291000000.0,14000000.0,,,,,,,,,,,240000000.0,,,,,,,,,,,,,,,,,,,74000000,,,,,316000000.0,,,,,38000000.0,,,,,,,,,,,,,-15000000.0,1000000.0,,,,,2000000.0,,,,,276000000.0,,,,-2000000.0,,,,41000000.0,-1000000.0,,,,,242000000.0,,,,,212000000.0,,,0.0,1322000000.0,,81000000.0,49000000.0,,,,,,0.0,114000000,,,,,,,,,,,,,,,,,,,,379000000.0,261000000.0,,73000000.0,,,,,1562000000,,,,390000000.0,,,,,,,,,,,583000000.0,,,8000000.0,,,,,,19000000.0,28000000.0,,,,,169000000.0,1910000000.0,,,,,2924000000.0,,,,,27000000.0,,,4000000.0,25000000.0,,,,,,,,,,,,,,,,,,,951000.0,,,,,,,,,,4340000000.0,,,,,,,,,,,,,,14299000000.0,,,,,,,,,,,,,,,,,,,,,,,,,,,,,,1
28,227000000,,,,,,,25000000.0,,,452000000,36000000.0,3346000000,,,-1558000000.0,4731000000.0,,,2000000.0,,,,,,12474000000.0,1465000000.0,,,,,,,,,,,,,,,,,,,,,,,,,,,,,,,,,,,,2160000000.0,1158000000.0,,840000000.0,-268000000.0,,,,,,1360000000.0,542392642.0,536425400.0,,,678000000.0,,60000000.0,,,,230000000.0,,,2665000000.0,4230000000.0,,21000000.0,10000000.0,695000000.0,,25000000.0,,,,,,,,,-137000000.0,-1000000.0,,-29000000.0,,96000000.0,30000000.0,-31000000.0,,,,,287000000.0,,,,,,,,,,,,,,,,,,,,,,,,,,,,,,,,,,,,,,,,,,,,,,,,,,,,,,,,,,27000000.0,,,,,,,,,,,,,0.0,,,,,,,,,0.0,,,,,,,,,,,,,,,,,,,,,,,,0.02,0.3,0.02,0.188,,,,97000000.0,166000000.0,,,,,,,,58000000.0,,,,,,,,,,,,,,,,,,,,,,,,,,,,,,-8000000.0,,,11000000.0,,,,-73000000.0,,,,249000000.0,40000000.0,,829000000.0,,,,,723000000.0,,259000000.0,,125000000.0,,,,,123000000.0,,,,0.0,,-1192000000.0,,36000000.0,,,10000000.0,,,11000000.0,207000000.0,-2000000.0,,,23000000.0,,,,51000000.0,,,,,,-101000000.0,,,,,,,3000000.0,,,,,,42000000.0,,,21000000.0,,89000000.0,,,368000000.0,,,,,,,,,,,,,,,,,,,,,,8479000000.0,12592000000.0,1022000000.0,,,,,,,,,,,5992000000.0,0.0,,,,,,,,6263000000.0,,,,,,,,43000000.0,,,,,,,280000000.0,,,,,,511000000.0,,,164000000.0,,,,,,,,,,,,,,,,,,,71000000,,,,,316000000.0,,,,,55000000.0,,,,,,1000000.0,,,,,,,23000000.0,0.0,,,,,10000000.0,,,,,276000000.0,,,,-5000000.0,,,,,,0.0,,,,323000000.0,,0.0,,,,,,,1287000000.0,,,48000000.0,,,,,,,142000000,,,,,,,,,,,,,,,-1000000.0,,,,,104000000.0,0.0,,112000000.0,,,281000000.0,,1544000000,,,,472000000.0,,,,,,,,,,,,,,23000000.0,,,615000000.0,,,26000000.0,26000000.0,,,,,219000000.0,,,,,,1805000000.0,,,,,83000000.0,,,51000000.0,,,,,,,,,,,,,,,,,,,,1400000.0,,,,,,,,,,4070000000.0,4197000000.0,,,,,,,,8583244.0,,,,,14299000000.0,,,,,,,,,,,,,,,,,,,,,,,,,,,,,,1
29,252000000,,,,,,,31000000.0,,,585000000,35000000.0,3319000000,,,-1558000000.0,4731000000.0,,,1000000.0,,56000000.0,31000000.0,,,12475000000.0,2088000000.0,,,,,,,,,,,,,,,,,,,,,,,,,,,,,,,,,,,,,,-225000000.0,,-79000000.0,,,,,,1360000000.0,542392642.0,536425400.0,,,,,,,,,190000000.0,,,,,,,,,,39000000.0,,,,,,,,,,,,-52000000.0,,101000000.0,64000000.0,,,,,,261000000.0,,,,,,,,,,,,,,,,,,,,,,,,,,,,,,,,,,,,,,,,,,,,,,,,,,,,,,,,,,,,,343000000.0,,,,,,42000000.0,,,,,16000000.0,,,,,,,,0.0,,,,,,,,,,,,,,,,,,,317000000.0,,,,,,0.21,,,,,,118000000.0,197000000.0,,,,,,,,58000000.0,,,,,,,,,,,,,,,,,,,,,,,,,,,,,,,,,,,,,73000000.0,,-3000000.0,,,40000000.0,,,,1000000.0,,,,55000000.0,,,,,1.03,1.02,,,,,,0.0,,,,-129000000.0,,-4000000.0,8000000.0,,,19000000.0,,-10000000.0,,,,,,,,,,-56000000.0,,0.0,14000000.0,-30000000.0,40000000.0,-17000000.0,-29000000.0,,,7000000.0,8000000.0,5000000.0,,3581000.0,,39000000.0,,,,114000000.0,118000000.0,,71000000.0,358000000.0,,,,,,,,,,,,,,,,,,,,,,8479000000.0,12592000000.0,1524000000.0,,,,,,,,,,,,0.0,,,,,,,,5936000000.0,,,,,,,,43000000.0,,-108000000.0,-57000000.0,-60000000.0,1110000000.0,,,,,,14268000000.0,,511000000.0,,,155000000.0,,,,,,,,,,,,,,,,,,,70000000,,,,,356000000.0,,,,,,,,,,,,,,,,,,,,,,,,,,,,,,,,-42000000.0,-14000000.0,180000000.0,8000000.0,,18000000.0,-1000000.0,123000000.0,,,,,700000000.0,0.0,,,54000000.0,,,,1230000000.0,85000000.0,-28000000.0,48000000.0,,,,,,,177000000,,,,,,,,,,,1398000000.0,,550000000.0,,,,,,,,0.0,,,,1116000000.0,,,1534000000,,,,442000000.0,,,,,,,,,,780000000.0,2000000.0,,,,,,615000000.0,,,,26000000.0,,,,32000000.0,219000000.0,7476000000.0,,,,,1641000000.0,,,,,,,,56000000.0,10000000.0,,,,,,,,,,,,,,,,,,,2400000.0,,,,,,,,,,4070000000.0,4353000000.0,,,,,,,,11410000.0,,,,,,,,,,,,,,,,,,,,,,,,,,,,,,,,,,,1
30,259000000,,,,,,,38000000.0,,,702000000,35000000.0,3393000000,,,-1558000000.0,4731000000.0,,,1000000.0,,,31000000.0,,,12338000000.0,1517000000.0,,,,,,,,,,,,,,,,,,,,,,,,,,,,,,,,,,,,1846000000.0,1121000000.0,,495000000.0,-418000000.0,,,,,,,542392642.0,536425400.0,,,683000000.0,,224000000.0,,,,225000000.0,,,1283000000.0,1424000000.0,,,,455000000.0,30000000.0,46000000.0,,,,,,,,,,,,,,,60000000.0,,,,,,240000000.0,,,,,,,,,,,,,,,,,,,,,,,,,,,,,,,,,,,,,,,,,,,,,,,,,,,,,,,,,,31000000.0,,,,,,,,,,,,0.0,0.0,,,,,,,,,0.0,,,,,,,,,,,,,,,,,,,,,,,,0.49,,0.49,,,,,132000000.0,213000000.0,,,,,,,,64000000.0,,,,,,,,,,,,,,,,,,,,,,,,,,,,,,-4000000.0,7000000.0,,3000000.0,,,,,,,,73000000.0,40000000.0,,348000000.0,,,,,,,,,84000000.0,,1.41,1.4,0.0,65000000.0,,,,1000000.0,,57000000.0,,,,,65000000.0,,,,,,,,,,,,,,,,,0.0,,,,,,,,12000000.0,,,,,,21000000.0,,87000000.0,,,85000000.0,,70000000.0,358000000.0,,,,,,,,,,,,,,,,,,,,,,8479000000.0,12592000000.0,1023000000.0,,,,,,,,,,,5928000000.0,,,,,,,,,5933000000.0,,,,-8000000.0,,,,43000000.0,,,,,,,,,,,,,511000000.0,,,155000000.0,,,,,,,,,,,,,,,,,,,75000000,,,,,278000000.0,,-1000000.0,,20000000.0,10000000.0,,,,9000000.0,,1000000.0,,,,-22000000.0,,,38000000.0,,,,,,,,,,,299000000.0,,,,-6000000.0,,,,,,,,,,81000000.0,,,,,,,,0.0,1201000000.0,,,48000000.0,,11000000.0,,,,,130000000,,,,,,,,,,,,,,,-4000000.0,,,,,,,,,,1116000000.0,,,1534000000,,,,485000000.0,,,,,,,,,,,,,,8000000.0,,,615000000.0,,,7000000.0,26000000.0,,,,,219000000.0,,,,,,1641000000.0,,,,,28000000.0,,,58000000.0,,,,,,,,,,,,,,,,,,,,2400000.0,,,,,,,,,,4070000000.0,4113000000.0,,,,,,,,,,,,,14218000000.0,,,,,,,,,,,,,,,,,,,,,540476000.0,537140000.0,,,,,,,,1
31,249000000,,,,,,,24000000.0,,,645000000,33000000.0,3338000000,,,-1558000000.0,,,,1000000.0,,,30000000.0,,,12592000000.0,1715000000.0,,,,,,,,,,,,,,,,,,,,,,,,,,,,,,,,,,,,,,-92000000.0,495000000.0,-784000000.0,,,,26.56,,,,,,,722000000.0,,,,,,225000000.0,,,,,,147000000.0,64000000.0,,,48000000.0,,,,,,,,,-66000000.0,11000000.0,,36000000.0,,,48000000.0,-1000000.0,,,,,268000000.0,,,,,,,,,,,,,,,,,,,,,,,,,,,,,,,,,,,,,,,,,,,,,,,,,,,,,,,,,,,,,472000000.0,,,,,,-1000000.0,,,,,5000000.0,,,,,,,,,,,,,,,,,,,,,,,,,,,573000000.0,,,,,0.29,0.24,0.29,0.073,,,,223000000.0,201000000.0,,,,,,,,62000000.0,,,,,,,,,,,,,,,,,,,,,,,,,,,,,,,,,,,,,7000000.0,,-21000000.0,,,,,,,0.0,,,2499000000.0,26000000.0,817000000.0,,,,,,0.0,,,,,1000000.0,,56000000.0,,,,8000000.0,14000000.0,,,62000000.0,696000000.0,-4000000.0,,,57000000.0,,,,102000000.0,,,9000000.0,,0.0,,-52000000.0,12000000.0,-16000000.0,-20000000.0,,,9000000.0,20000000.0,23000000.0,,,,,,,5000000.0,168000000.0,111000000.0,,70000000.0,358000000.0,,,,,,,,,,,,,,,,,,,,,,,,1165000000.0,,,,,,,,,,,5924000000.0,150000000.0,,,,,,,,5930000000.0,,,,,,,,,,-184000000.0,-115000000.0,207000000.0,1116000000.0,,1616000000.0,,,,,,302000000.0,,,415000000.0,,,,,,,,,,,,,,,,,,,74000000,,,,,279000000.0,,1000000.0,,,,,,,,,,,,,,,,,,,,,,23000000.0,,,,,295000000.0,,,-2000000.0,-11000000.0,178000000.0,5000000.0,,27000000.0,0.0,203000000.0,,,,,932000000.0,0.0,,,122000000.0,,,149000000.0,1487000000.0,101000000.0,-58000000.0,40000000.0,,,,,,,98000000,,,,,,,,,,,1698000000.0,,550000000.0,,,,,,,8000000.0,,,81000000.0,,,441000000.0,,1618000000,,,,396000000.0,,,,,,,,,,780000000.0,6000000.0,,,,,,615000000.0,,,,,,,,26000000.0,,,,,,,4888000000.0,,,,,,,,7000000.0,18000000.0,,,,,,,,,,,,,,,,,,,1300000.0,,,,,,,,,,,,,,,,,,,,,,,,13669000000.0,,,,,,,,,,,,,,,,,,,,,,,,,,,,,,1
32,249000000,,,,,,,24000000.0,,,645000000,33000000.0,3338000000,,,,4827000000.0,,,,,8000000.0,32000000.0,,,12592000000.0,1715000000.0,,,,,,,,,,,,,,,,,,,,,,,,,,,,,,,,,,,,1368000000.0,1046000000.0,,495000000.0,,,,,,1.25,,546572906.0,,,,728000000.0,,158000000.0,,,,,,,4055000000.0,4993000000.0,,,,,,48000000.0,,,,,,,,,,,,,,,48000000.0,,,,,,268000000.0,,,,,,,,,,,,,,,,,,,,,,,,,,,,,,,,,,,,,,,,,,,,,,,,,,,,,,,,,,,,,458000000.0,,,,,,,,,0.0,,,,,,,,,,0.0,,,,,,,,,,,,,,,,,,,,,,,,0.29,,0.29,,,,,150000000.0,201000000.0,,,,,,,,62000000.0,,,,,,,,,,,,,,,,,,,,,,,,,,,,,,-6000000.0,-2000000.0,,28000000.0,,,,9000000.0,,,,338000000.0,,,1249000000.0,,,,,,26000000.0,,,242000000.0,,0.33,0.43,,612000000.0,,,,,,52000000.0,,56000000.0,,,14000000.0,,,,,,,,,,,,,,,,,0.0,,,,,,,,,,,,2647000.0,,58000000.0,,173000000.0,,,111000000.0,,70000000.0,358000000.0,,,,,,,,,,,,,,,,,,,,,,8234000000.0,12510000000.0,1165000000.0,,,,,,,,0.0,,,5921000000.0,,,,,,,,,5930000000.0,,,,,,,,32000000.0,,,,,1116000000.0,,,,,,,,302000000.0,,,400000000.0,,,,,,,,,,,,,,,,,,,74000000,,,,,289000000.0,,-1000000.0,,141000000.0,112000000.0,,,,24000000.0,,0.0,,,,-1000000.0,,,-171000000.0,1000000.0,,,,,,,,,,291000000.0,,,,17000000.0,18000000.0,,,,,,,,,161000000.0,,,,,,,,,1487000000.0,,,40000000.0,,22000000.0,,,,,98000000,,,,,,,,,,,,,,,-5000000.0,,,,,,,,,,,,,1618000000,,,,396000000.0,,,,,,,,,,,,,,32000000.0,,,,,,36000000.0,19000000.0,,,,4000000.0,264000000.0,1636000000.0,,,,,4438000000.0,,,,,112000000.0,,,8000000.0,,,,,,,,,,,,,,,,,,,,1400000.0,,,,,,,,,,4244000000.0,4113000000.0,,,,,,,,2348635.0,,,,,13627000000.0,,,,,,,,,,,,,,,,,,,,,540790000.0,537873000.0,,,,,,,,1
33,249000000,,,,,,,24000000.0,,,645000000,33000000.0,3338000000,,,,6290000000.0,,,,,,,,,12592000000.0,1715000000.0,,,,,,,,,,,,,,,,,,,,,,,,,,,,,,,,,,,,,1048000000.0,-345000000.0,495000000.0,,,,,26.46,1.25,,577873544.0,537408938.0,,,729000000.0,,,,,,225000000.0,,,,5810000000.0,,,,,74000000.0,48000000.0,,,,,,,,,,,,125000000.0,,,48000000.0,,,,,,268000000.0,,,,,,,,,,,,,,,,,,,,,,,,,,,,,,,,,,,,,,,,,,,,,,,,,,,,,,,,,,,,,,,,,,,368000000.0,,,,,130000000.0,,,,,,,,,,,,,,,,,,,,,,,,,,,8000000.0,,,,,,0.03,,,,,,150000000.0,147000000.0,,,,,,,,63000000.0,,,,,,,,,,,,,,,,,,,,,,,,,,,,,,,,,,,,,15000000.0,,-18000000.0,,,,,,,2000000.0,,,1982000000.0,,323000000.0,,,,0.43,0.26,0.0,,,,,,,,,120000000.0,,,14000000.0,,,27000000.0,484000000.0,-2000000.0,,,41000000.0,,,,125000000.0,,,10000000.0,,,,-64000000.0,34000000.0,-19000000.0,-32000000.0,,,,18000000.0,33000000.0,,,,55000000.0,,,10000000.0,290000000.0,111000000.0,,70000000.0,,,,,,,,,,,,,,,,,,,,,,,8002000000.0,13908000000.0,1165000000.0,,,,,,,,0.0,,,5919000000.0,0.0,,,,,,,,5930000000.0,,,,,,,,38000000.0,,-393000000.0,-281000000.0,329000000.0,,,1153000000.0,,,,,,302000000.0,,,167000000.0,,,,,,,,,,,,,,,,,,,74000000,,,,,312000000.0,,,,,,,,,,,,,,,,,,,,,,,,34000000.0,,,,,275000000.0,,,-11000000.0,6000000.0,,12000000.0,,33000000.0,1000000.0,,,,,,,,,,197000000.0,,,149000000.0,1487000000.0,,-39000000.0,40000000.0,,,,,,,98000000,,,,,,,,,,,1698000000.0,,,,,,,,,12000000.0,,,132000000.0,,1283000000.0,468000000.0,,1618000000,,,,396000000.0,,,,,,,,,,,187000000.0,,,,,,,,,,15000000.0,,,,,350000000.0,,,,,,1664000000.0,,,,,,,,8000000.0,28000000.0,,,,,,,,,,,,,,,,,,,1500000.0,,,,,,,,,,5868000000.0,4113000000.0,,,,,,,,2300000.0,,,,,12954000000.0,,,,,,,,,,,,,,,,,,,,,,,,,,,,,,1
34,249000000,,,,,,,27000000.0,,,645000000,35000000.0,3338000000,,,-1530000000.0,6420000000.0,,,1000000.0,,12000000.0,34000000.0,,,12592000000.0,1715000000.0,,,,,,,,,,,,,,,,,,,,,,,,,,,,,,,,,,,,1467000000.0,1012000000.0,,,,,,,26.46,1.25,1360000000.0,582577811.0,537526343.0,,,729000000.0,,6000000.0,,,,225000000.0,,,1390000000.0,,,378000000.0,243000000.0,,,32000000.0,,,,,,,,,27000000.0,-11000000.0,,,,,31000000.0,-2000000.0,,,,,268000000.0,,,,,,,,,,,,,,,,,,,,,,,,,,,,,,,,,,,,,,,,,,,,,,,,,,,,,,,,,,,,,126000000.0,,,,,,42000000.0,,,0.0,,16000000.0,,,,,,,,,,,,,,,,,,,,,,,,,,,,,,,,0.62,,0.61,0.376,,,,150000000.0,,,,,,,,,65000000.0,,,,,,,,,,,,,,,,,,,,,,,,,,,,,,2000000.0,8000000.0,,,,,,16000000.0,,,,306000000.0,40000000.0,,996000000.0,,13000000.0,,,,,,,117000000.0,,0.22,0.56,,,,,,,,-4000000.0,,,,-50000000.0,14000000.0,,,,,,,,,,,,,,,23000000.0,,0.0,,,,-49000000.0,,,,,,,,2675000.0,,54000000.0,,86000000.0,,,111000000.0,,,386000000.0,,,,,,,,,,,,,,,,,,,,,,9492000000.0,15609000000.0,1165000000.0,,,,,,,,0.0,,,6344000000.0,,,,,,,,,5930000000.0,,,,-8000000.0,,,,39000000.0,,,,,,,1153000000.0,,,,,,302000000.0,,,167000000.0,,,,,,,,,,,,,,,,,,,74000000,,,,,312000000.0,,0.0,,121000000.0,5000000.0,,,,15000000.0,,0.0,,,,21000000.0,,,-194000000.0,-1000000.0,,,,,35000000.0,,,,,275000000.0,,,-9000000.0,,28000000.0,,,,,253000000.0,,,,242000000.0,233000000.0,,,,,,,,1487000000.0,20000000.0,,40000000.0,,11000000.0,,,,,98000000,,,,,,,,,,,,,0.0,,-3000000.0,,,,,,,,,,,,,1618000000,,,,396000000.0,,,,,,,,,,0.0,,,,,,,,,,10000000.0,14000000.0,,,,10000000.0,379000000.0,1643000000.0,,,,,1664000000.0,,,,,97000000.0,,,14000000.0,,,,,,,,,,,,,,,,,,,,829000.0,,,,,,,,,,6078000000.0,4113000000.0,,,,,,,,2300000.0,,,,,12954000000.0,,,,,,,,,,,,,,,,,,,,,541095000.0,538599000.0,,,,,,,,1
35,245000000,,,,,,,,,,457000000,,3354000000,,,-1463000000.0,6444000000.0,,,1000000.0,,19000000.0,30000000.0,,,,1919000000.0,,,,,,,,,,,,,,,,,,,,,,,,,,,,,,,,,,,,1467000000.0,1012000000.0,,,,,,,,,1360000000.0,583548428.0,542392642.0,,,729000000.0,,,,,,275000000.0,,,5447000000.0,,,252000000.0,158000000.0,,,,,,,,,,,,28000000.0,-64000000.0,,,,,,6000000.0,,,,,244000000.0,,,,,,,,,,,,,,,,,,,,,,,,,,,,,,,,,,,,,,,,,,,,,,,,,,,,,,,,,,,,,252000000.0,,,,,,76000000.0,,,,,-24000000.0,,,,,,,,,,,,,,,,,,,,,,,,,,,573000000.0,,,,,,,,0.641,,,,109000000.0,,,,,,,,,,,,,,,,,,,,,,,,,,,,,,,,,,,,,,,-7000000.0,6000000.0,,,,,,,,,,,40000000.0,,,,13000000.0,,,,,,,312000000.0,,0.56,0.23,0.0,0.0,,,,,,-52000000.0,,,,-45000000.0,24000000.0,,,,,,,,,,,,,,,,,,,,,,,,,,,,,2704000.0,,,,260000000.0,,,84000000.0,,,340000000.0,,,,,,,,,,,,,,,,,,,,,,7666000000.0,14498000000.0,911000000.0,,,,,,,,,,,6344000000.0,,,,,,,,,5928000000.0,,,,0.0,,,,3000000.0,,,,,,,,,,,,,302000000.0,,,160000000.0,,,,,,,,,,,,,,,,,,,79000000,,,,,312000000.0,,-2000000.0,,170000000.0,29000000.0,,,,-1000000.0,,-1000000.0,,,,-27000000.0,,,-707000000.0,1000000.0,,,,,12000000.0,,,,,275000000.0,,,-6000000.0,15000000.0,10000000.0,,,,,407000000.0,,,,334000000.0,466000000.0,,,,,,,,1454000000.0,39000000.0,,,,33000000.0,,,,,118000000,,,,,,,,,,,0.0,,0.0,,,,,,,,,,,,171000000.0,,,1573000000,,,,481000000.0,,,,,,,,,,0.0,,,,,,,362000000.0,,,42000000.0,,,,,,294000000.0,,,,,,1514000000.0,,,,,,,,,,,,,,,,,,,,,,,,,,,,,,,,,,,,,,6795000000.0,4276000000.0,,,,,,,,,,,,,12954000000.0,,,,,,,,,,,,,,,,,,,,,540469000.0,537906000.0,,,,,,,,1
36,270000000,,,,,,,,,,543000000,,3370000000,,,-686000000.0,6444000000.0,,,1000000.0,,,29000000.0,,,12510000000.0,2228000000.0,,,,,,,,,,,,,,,,,,,,,,,,,,,,,,,,,,,,1467000000.0,1012000000.0,,,,,,,26.61,,1360000000.0,583548428.0,542392642.0,,,,,172000000.0,,,,282000000.0,,,,2825000000.0,,,,,,,,,,,,,,,,,,196000000.0,,,,,,,,,168000000.0,,,,,,,,,,,,,,,,,,,,,,,,,,,,,,,,,,,,,,,,,,,,,,,,,,,,,,,,,,,,,,,,,,,33000000.0,,,,,-14000000.0,,,,,,,,,,,,,,,,,,,,,,,,,,,,,,,,0.12,0.17,0.12,,,,,192000000.0,,,,,,,,,,,,,,,,,,,,,,,,,,,,,,,,,,,,,,,,,,13000000.0,,,,16000000.0,,-2000000.0,,145000000.0,40000000.0,,895000000.0,,,,,,101000000.0,,,384000000.0,,0.78,0.35,,,,,,,,,,164000000.0,,,23000000.0,,,,,,,,,,,,,,,,,,,,,,,,,,,,,,,20000000.0,,,13000000.0,,108000000.0,,70000000.0,383000000.0,,,,,,,,,,,,,,,,,,,,,,7745000000.0,14577000000.0,1022000000.0,,,,,,,,0.0,,,,,,,,,,,,5924000000.0,,,,,,,,3000000.0,,,,,,,1782000000.0,,,,,,302000000.0,,,468000000.0,,,,,,,,,,,,,,,,,,,73000000,,,,,,,,,,24000000.0,,,,,,,,,,,,,,0.0,,,,,43000000.0,,,,,,,,-32000000.0,16000000.0,,1000000.0,,,,,,,,93000000.0,,,,,,,,18000000.0,1224000000.0,,,,,,,,,,146000000,,,,,,,,,,,0.0,,0.0,,9000000.0,,,,,26000000.0,,,162000000.0,,,,,1597000000,,,,491000000.0,,,,,,,,,,0.0,,,,15000000.0,,,362000000.0,,,,,,,,3000000.0,294000000.0,3335000000.0,,,,,6552000000.0,,,,,56000000.0,,,,,,,,,,,,,,,,,,,,,,,,,,,,,,,,,6795000000.0,5906000000.0,,,,,,,,0.0,,,,,,,,,,,,,,,,,,,,,,,,,,,,,,,,,,,1
37,271000000,,,,,,,,,,491000000,,3411000000,,,-686000000.0,6444000000.0,,,1000000.0,,7000000.0,,,,13908000000.0,1714000000.0,,,,,,,,,,,,,,,,,,,,,,,,,,,,,,,,,,,,,1012000000.0,-259000000.0,,,,,,,,,583548428.0,542392642.0,,,731000000.0,,,,,,255000000.0,,,,3197000000.0,,,,,,,,,,,,,,,,,,,,,,,,,,,71000000.0,,,,,,,,,,,,,,,,,,,,,,,,,,,,,,,,,,,,,,,,,,,,,,,,,,,,,,,,,,,,,375000000.0,,,,,,163000000.0,,,,,-52000000.0,,,,,,,,,,,,,,,,,,,,,,,,,,,914000000.0,,,,,,,,,,,,,,,,,,,,,,,,,,,,,,,,,,,,,,,,,,,,,,,,,,,,,,,,,,-16000000.0,,,,129000000.0,,,804000000.0,,0.0,,,,101000000.0,,,,,0.24,0.71,15000000.0,0.0,,,,,,-104000000.0,,,,-40000000.0,140000000.0,,,,,,,,,,,,,,,-66000000.0,,,,-67000000.0,68000000.0,-2000000.0,3000000.0,,,,13000000.0,165000000.0,,2585000.0,,,,87000000.0,,111000000.0,84000000.0,,70000000.0,383000000.0,,,,,,,,,,,,,,,,,,,,,,7745000000.0,14577000000.0,1273000000.0,,,,,,,,,,,6401000000.0,,,,,,,,,5921000000.0,,,,-8000000.0,,,,37000000.0,,-156000000.0,-42000000.0,-61000000.0,171000000.0,,,,,,,,0.0,,,454000000.0,,,,,,,,,,,,,,,,,,,69000000,,,,,444000000.0,,-1000000.0,,29000000.0,40000000.0,,,,-25000000.0,,0.0,,,,-26000000.0,,,14000000.0,1000000.0,,,,,45000000.0,,,,,398000000.0,,,-6000000.0,10000000.0,30000000.0,0.0,,16000000.0,0.0,484000000.0,,,,202000000.0,699000000.0,,,,35000000.0,,,,885000000.0,59000000.0,24000000.0,,,11000000.0,,,,,140000000,,,,,,,,,,,225000000.0,,,,,,,,,,,,,,99000000.0,,,1672000000,,,,444000000.0,,,,,,,,,,,156000000.0,,,,,,362000000.0,,,,,,,,12000000.0,294000000.0,,,,,,5954000000.0,,,,,49000000.0,,,,12000000.0,,,,,,,,,,,,,,,,,,,,,,,,,,,,,6795000000.0,6117000000.0,,,,,,,,,,,,,12888000000.0,,,,,,,,,,,,,,,,,,,,,539827000.0,537969000.0,,,,,,,,1
38,222000000,,,,,,,,,,490000000,,3376000000,,,-686000000.0,,,,,,24000000.0,32000000.0,,,15609000000.0,1602000000.0,,,,,,,,,,,,,,,,,,,,,,,,,,,,,,,,,,,,,,,1016000000.0,,,,,,,,,542392642.0,,,733000000.0,,390000000.0,,,,136000000.0,,,1430000000.0,1453000000.0,,,,,,,,,,,,,,,,,,110000000.0,,,,,,,,,15000000.0,,,,,,,,,,,,,,,,,,,,,,,,,,,,,,,,,,,,,,,,,,,,,,,,,,,,,,,,,,,,,,,,,,,87000000.0,,,,,-28000000.0,,,,,,,,,,,,,,,,,,,,,,,,,,,467000000.0,,,,,0.08,0.77,0.08,0.188,,,,,,,,,,,,,,,,,,,,,,,,,,,,,,,,,,,,,,,,,,,-14000000.0,-4000000.0,,7000000.0,,,,5000000.0,,-24000000.0,,71000000.0,,,477000000.0,,,,,,,,,144000000.0,,0.35,,13000000.0,,,,,,,,,44000000.0,,,137000000.0,,,,,,,,,,,,,,,,,,,,,-3000000.0,,,,,,,,,,11000000.0,,,,,109000000.0,,69000000.0,383000000.0,,,,,,,,,,,,,,,,,,,,,,7745000000.0,14577000000.0,1939000000.0,,,,,,,,,,,6293000000.0,,,,,,,,,5419000000.0,,,,,,,,37000000.0,,,,,,,,,,,,,0.0,,,,,,,,,,,,,,,,,,,,,,58000000,,,,,461000000.0,,,,,11000000.0,,,,,,,,,,,,,,0.0,,,,,9000000.0,,,,,397000000.0,,,,7000000.0,32000000.0,1000000.0,,,4000000.0,,,,,330000000.0,,,,,,,,283000000.0,527000000.0,,,,,,,,,,152000000,,,,,,,,,,,,,0.0,,12000000.0,,,,,2000000.0,,,,,99000000.0,,,1857000000,,,,337000000.0,,,,,,,,,,0.0,,,,8000000.0,,,362000000.0,,,1000000.0,,,,,7000000.0,,1692000000.0,,,,,,,,,,28000000.0,,,,,,,,,,,,,,,,,,,,,,,,,,,,,,,,,,6832000000.0,,,,,,,,,,,,,12790000000.0,,,,,,,,,,,,,,,,,,,,,,,,,,,,,,1
39,222000000,,,,,,,,,,490000000,,3376000000,,,-686000000.0,6464000000.0,,,,,,32000000.0,,,14498000000.0,1602000000.0,,,,,,,,,,,,,,,,,,,,,,,,,,,,,,,,,,,,,,1464000000.0,,,,,,,1.25,,584961444.0,,,,657000000.0,,,,,,136000000.0,,,,1664000000.0,,,,,,,,,,,,,,,,,,13000000.0,,,,,,,,,15000000.0,,,,,,,,,,,,,,,,,,,,,,,,,,,,,,,,,,,,,,,,,,,,,,,,,,,,,,,,,,,,,493000000.0,,,,,,150000000.0,,,,,55000000.0,,,,,,,,,,,,,,,,,,,,,,,,,,,1385000000.0,,,,,,0.35,,,,,,,,,,,,,,,,,,,,,,,,,,,,,,,,,,,,,,,,,,,,,,,,,,,,,,,,63000000.0,,,421000000.0,,14000000.0,,,,,,,327000000.0,,0.71,0.89,36000000.0,0.0,,,,,,-62000000.0,,,,-37000000.0,137000000.0,,,,,,,,,,,,,,,-32000000.0,,,,-64000000.0,36000000.0,15000000.0,7000000.0,,,,14000000.0,120000000.0,,2403000.0,,,,348000000.0,1000000.0,166000000.0,109000000.0,,79000000.0,383000000.0,,,,,,,,,,,,,,,,,,,,,,7620000000.0,14505000000.0,1939000000.0,,,,,,,,,,,6590000000.0,,,,,,,,,5419000000.0,,,,8000000.0,,,,33000000.0,,1222000000.0,-71000000.0,313000000.0,99000000.0,,166000000.0,,,,,,,,,53000000.0,,,,,,,,,,,,,,,,,,,60000000,,,,,461000000.0,,-3000000.0,,351000000.0,95000000.0,,,,-11000000.0,,0.0,,,,-50000000.0,,,70000000.0,-2000000.0,,,,,10000000.0,,,,,383000000.0,,,,4000000.0,2000000.0,0.0,,34000000.0,,518000000.0,,,,,941000000.0,,,,82000000.0,,,286000000.0,527000000.0,83000000.0,52000000.0,,,44000000.0,,,,,152000000,,,,,,,,,,,225000000.0,,,,,,,,,2000000.0,,,15000000.0,,,,,1857000000,,,,337000000.0,,,,,,,,,,,177000000.0,,,,,,,,,1000000.0,,,,,2000000.0,344000000.0,1692000000.0,,,,,,,,,,24000000.0,,,,22000000.0,,,,,,,,,,,,,,,,,,,,,,,,,,,,,6852000000.0,,,,,,,,,2349000.0,,,,,12727000000.0,,,,,,,,,,,,,,,,,,,,,539879000.0,537534000.0,,,,,,,,1
40,222000000,,,,,,,,,,490000000,,3376000000,,,,6513000000.0,,,,,20000000.0,29000000.0,,,14498000000.0,1602000000.0,,,,,,,,,,,,,,,,,,,,,,,,,,,,,,,,,,,,,,,1777000000.0,,,,,,1.25,,586697717.0,542393000.0,,,656000000.0,,218000000.0,,,,136000000.0,,,3013000000.0,4304000000.0,,,,,,,,,,,,,,,,,,,,,,,,,,,15000000.0,,,,,,,,,,,,,,,,,,,,,,,,,,,,,,,,,,,,,,,,,,,,,,,,,,,,,,,,,,,,,,,,,,,,,,,,,,,,,,,,,,,,,,,,,,,,,,,,,,,471000000.0,,,,,0.23,,0.23,,,,,,,,,,,,,,,,,,,,,,,,,,,,,,,,,,,,,,,,,,,,-2000000.0,-8000000.0,,14000000.0,,,,,,24000000.0,,205000000.0,,,1348000000.0,,,,,,257000000.0,,,342000000.0,,,0.46,21000000.0,,,,,,,,,201000000.0,,,137000000.0,,,,,,,,,,,,,,,,,,,,,,,,,,,,,,,27000000.0,,,,,109000000.0,,79000000.0,,,,,,,,,,,,,,,,,,,,,,,8563000000.0,15706000000.0,1939000000.0,,,,,,,,,,,6147000000.0,,,,,,,,,5419000000.0,,,,0.0,,,,2000000.0,,,,,99000000.0,,,,,,,,,,,54000000.0,,,,,,,,,,,,,,,,,,,60000000,,,,,414000000.0,,,,,2000000.0,,,,,,,,,,,,,,0.0,,,,,52000000.0,,,,,377000000.0,,,,14000000.0,4000000.0,6000000.0,,,-5000000.0,,,,,,,,,,,,,295000000.0,527000000.0,,,,,,,,,,152000000,,,,,,,,,,,,,,,22000000.0,,,,,2000000.0,,,,,,,,1857000000,,,,337000000.0,,,,,,,,,,,,,,23000000.0,,,,,,0.0,,,,,1000000.0,495000000.0,,,,,,1516000000.0,,,,,83000000.0,,,,,,,,,,,,,,,,,,,,,,,,,,,,,,,,,7092000000.0,6832000000.0,,,,,,,,,,,,,12671000000.0,,,,,,,,,,,,,,,,,,,,,,,,,,,,,,1
41,222000000,,,,,,,,,,490000000,,3376000000,,,,4548000000.0,,,1000000.0,,1000000.0,30000000.0,,,14577000000.0,1602000000.0,,,,,,,,,,,,,,,,,,,,,,,,,,,,,,,,,,,,,,499000000.0,,,,,,0.15,1.25,1360000000.0,525484841.0,,,,656000000.0,,,,,,102000000.0,,,,4925000000.0,,,,,,,,,,,,,,,,,,16000000.0,,,,,,,,,15000000.0,,,,,,,,,,,,,,,,,,,,,,,,,,,,,,,,,,,,,,,,,,,,,,,,,,,,,,,,,,,,,338000000.0,,,,,,29000000.0,,,,,-9000000.0,,,,,,,,,,,,,,,,,,,,,,,,,,,1860000000.0,,,,,0.16,0.77,0.16,0.214,,,,,,,,,,,,,,,,,,,,,,,,,,,,,,,,,,,,,,,,,,,,,,,,,,,,-3000000.0,,184000000.0,,,1182000000.0,,1000000.0,,,,,,,185000000.0,,0.89,,72000000.0,0.0,,,,,,,,,,,137000000.0,,,,,,,,,,,,,,,45000000.0,,,,-77000000.0,0.0,38000000.0,8000000.0,,,,16000000.0,112000000.0,,2271000.0,,,,344000000.0,3000000.0,275000000.0,109000000.0,,79000000.0,445000000.0,,,,,,,,,,,,,,,,,,,,,,7584000000.0,13440000000.0,1939000000.0,,,,,,,,,,,6377000000.0,,,,,,,,,5419000000.0,,,,,,,,0.0,,1561000000.0,-1718000000.0,656000000.0,,,90000000.0,,,,,,,,,238000000.0,,,,,,,,,,,,,,,,,,,60000000,,,,,414000000.0,,0.0,,13000000.0,,,,,16000000.0,,1000000.0,,,,,,,56000000.0,,,,,,,,,,,377000000.0,,,,5000000.0,25000000.0,7000000.0,,43000000.0,,,,,,,,,,,151000000.0,,,0.0,527000000.0,,79000000.0,,,,,,,,152000000,,,,,,,,,,,,,,,,,,,,4000000.0,,,54000000.0,,109000000.0,,,1857000000,,,,398000000.0,,,,,,,,,,,340000000.0,,,,,,,,,2000000.0,,,,,390000000.0,1494000000.0,5006000000.0,,,,,1578000000.0,,,,,73000000.0,,,,34000000.0,,,,,,,,,,,,,,,,,,,,,,,,,,,,,5856000000.0,6832000000.0,,,,,,,,,,,,,,,,,,,,,,,,,,,,,,,,,,,,,,,,,,,1
42,243000000,,,,,,,,,,411000000,,3424000000,,,-663000000.0,4519000000.0,,,1000000.0,,3000000.0,32000000.0,,,14577000000.0,1774000000.0,,,,,,,,,,,,,,,,,,,,,,,,,,,,,,,,,,,,1463000000.0,415000000.0,-63000000.0,,,,,,,,1360000000.0,524474315.0,577873544.0,,,656000000.0,,,,,,,,,,1728000000.0,,,,,,,,,,,,,,,,,,10000000.0,,,,,,,,,18000000.0,,,,,,,,,,,,,,,,,,,,,,,,,,,,,,,,,,,,,,,,,,,,,,,,,,,,,,,,,,,,,,,,,,,,,,,,,,,,,,,,,,,,,,,,,,,,,,,,,,,430000000.0,,,,,,0.42,,0.184,,,,,,,,,,,,,,,,,,,,,,,,,,,,,,,,,,,,,,,,,,,,,,,,,,,,-6000000.0,,55000000.0,,,378000000.0,,15000000.0,,,,130000000.0,,,473000000.0,,0.16,,0.0,,,,,,,,,19000000.0,,,163000000.0,,,,,,,,,,,,,,,-51000000.0,,,,-76000000.0,13000000.0,22000000.0,7000000.0,,,,26000000.0,27000000.0,,,,,,,4000000.0,366000000.0,66000000.0,,,389000000.0,,,,,,,,,,,,,,,,,,,,,,8153000000.0,13457000000.0,1201000000.0,,,,,,,,,,,6377000000.0,,,,,,,,,6156000000.0,,,,,,,,,,762000000.0,-1829000000.0,1004000000.0,109000000.0,,,,,,,,,,,236000000.0,,,,,,,,,,,,,,,,,,,81000000,,,,,414000000.0,,0.0,,90000000.0,,,,,-9000000.0,,,,,,,,,80000000.0,,,,,,14000000.0,,,,,377000000.0,,,,11000000.0,,,,59000000.0,,,,,,,,,,,261000000.0,,,,542000000.0,,101000000.0,,,11000000.0,,,,,141000000,,,,,,,,,,,0.0,,,,,,,,,,,,84000000.0,,10000000.0,,,1917000000,,,,,,,,,,,,,,,1567000000.0,,,,,,0.0,,,10000000.0,,,,,,1508000000.0,1671000000.0,,,,,1422000000.0,,,,,24000000.0,,,,42000000.0,,,,,,,,,,,,,,,,,,,,,,,,,,,,,,,,,,,,,,0.0,,,,,,,,,,,,,,,,,,,,,,,,,,,,,,,,,,,1
43,271000000,,,,,,,,,,510000000,,3437000000,,,-857000000.0,4519000000.0,,,1000000.0,,,32000000.0,,,14372000000.0,1696000000.0,,,,,,,,,,,,,,,,,,,,,,,,,,,,,,,,,,,,,492000000.0,,1999000000.0,,,,,,,1360000000.0,524474315.0,582577811.0,,,,,202000000.0,,,,,,,4602000000.0,5716000000.0,,,,,,,,,,,,,,,,,,,,,,,,,,,33000000.0,,,,,,,,,,,,,,,,,,,,,,,,,,,,,,,,,,,,,,,,,,,,,,,,,,,,,,,,,,,,,241000000.0,,,,,,52000000.0,,,,,-14000000.0,,,,,,,,,,,,,,,,,,,,,,,,,,,886000000.0,,,,,0.45,,0.45,,,,,,,,,,,,,,,,,,,,,,,,,,,,,,,,,,,,,,,,,,,,-15000000.0,-7000000.0,,19000000.0,,,,,,,,289000000.0,,,1820000000.0,,,,,,,,,509000000.0,,0.47,0.55,10000000.0,,,,,,,2000000.0,,32000000.0,,5000000.0,157000000.0,,,,,,,,,,,,,,,,,,,,,,,,,,,,,0.0,,37000000.0,,163000000.0,,,102000000.0,,79000000.0,389000000.0,,,,,,,,,,,,,,,,,,,,,,8153000000.0,13457000000.0,1223000000.0,,,,,,,,,,,,,,,,,,,,6153000000.0,,,,-37000000.0,,,,,,,,,,,,,,,,,,,,,,,,,,,,,,,,,,,,,,,74000000,,,,,,,,,77000000.0,,,,,-25000000.0,,,,,,-35000000.0,,,,,,,,,6000000.0,,,,,,,,,12000000.0,74000000.0,,,,,1629000000.0,,,,,485000000.0,,,,,,,,515000000.0,29000000.0,,,,22000000.0,,,,,132000000,,,,,,,,,,,0.0,,,,,,,,,,,,,,10000000.0,,,1901000000,,,,,,,,,,,,,,,,,,33000000.0,,,0.0,,,,,,,,21000000.0,1508000000.0,1671000000.0,,,,,,,,,,113000000.0,,,,,,,,,,,,,,,,,,,,,,,,,,,,,,,,,4869000000.0,6885000000.0,,,,,,,,0.0,,,,,,,,,,,,,,,,,,,,,,,,,,539880000.0,537667000.0,,,,,,,,1
44,242000000,,,,,,,,,,487000000,,3471000000,,,-1393000000.0,4519000000.0,,,,,5000000.0,30000000.0,,,14505000000.0,1817000000.0,,,,,,,,,,,,,,,,,,,,,,,,,,,,,,,,,,,,881000000.0,,,1999000000.0,,,,,0.3,,,524474315.0,583548428.0,,,648000000.0,,,,,,,,,,,,,,,,,,,,,,,,,,,,0.0,,,,,,,,,31000000.0,,,,,,,,,,,,,,,,,,,,,,,,,,,,,,,,,,,,,,,,,,,,,,,,,,,,,,,,,,,,,,,,,,,,,,,,,,,,,,,,,,,,,,,,,,,,,,,,,,,,,,,,0.22,1.11,0.22,,,,,,,,,,,,,,,,,,,,,,,,,,,,,,,,,,,,,,,,,,,,,,,,,,,,,-3000000.0,,259000000.0,,,1538000000.0,,0.0,,,,,,,146000000.0,,,,32000000.0,,,,,,,,,13000000.0,,,149000000.0,,,,,,,,,,,,,,,,,,,,,21000000.0,,,,,,,,,,38000000.0,,162000000.0,7000000.0,,73000000.0,,79000000.0,389000000.0,,,,,,,,,,,,,,,,,,,,,,8153000000.0,13457000000.0,1169000000.0,,,,,,,,,,,7426000000.0,,,,,,,,,6150000000.0,,,,37000000.0,,,,,,,,,10000000.0,,223000000.0,,,,,,,,,363000000.0,,,,,,,,,,,,,,,,,,,69000000,,,,,399000000.0,,-1000000.0,,122000000.0,,,,,-62000000.0,,1000000.0,,,,,,,10000000.0,,,,,,20000000.0,,,,,352000000.0,,,,,75000000.0,,,,0.0,,,,,,,,,,,,,,506000000.0,,,,,,,,,,141000000,,,,,,,,,,,,,,,2000000.0,,,,,,,,119000000.0,,,,,1860000000,,,,,,,,,,,,,,,,,,,,,0.0,,,8000000.0,,,,,19000000.0,1508000000.0,,,,,,3032000000.0,,,,,99000000.0,,,,,,,,,,,,,,,,,,,,,,,,,,,,,,,,,9046000000.0,7143000000.0,,,,,,,,0.0,,,,,,,,,,,,,,,,,,,,,,,,,,,,,,,,,,,1
45,246000000,,,,,,,,,,530000000,,3477000000,,,-1393000000.0,,,,,,,33000000.0,,,15706000000.0,1611000000.0,,,,,,,,,,,,,,,,,,,,,,,,,,,,,,,,,,,,,779000000.0,-55000000.0,1999000000.0,,,,,,,,,583548428.0,,,643000000.0,,1435000000.0,,,,,,,1589000000.0,6709000000.0,,,,,,,,,,,,,,,,,,-58000000.0,,,,,,,,,72000000.0,,,,,,,,,,,,,,,,,,,,,,,,,,,,,,,,,,,,,,,,,,,,,,,,,,,,,,,,,,,,,359000000.0,,,,,,128000000.0,,,,,-46000000.0,,,,,,,,,,,,,,,,,,,,,,,,,,,456000000.0,,,,,0.22,,0.22,,,,,,,,,,,,,,,,,,,,,,,,,,,,,,,,,,,,,,,,,,,,-13000000.0,,,,,,,,,,,252000000.0,,,,,2000000.0,,,,439000000.0,,,167000000.0,,0.22,,,,,,,,,17000000.0,,16000000.0,,4000000.0,98000000.0,,,,,,,,,,,,,,,-80000000.0,,,,-2000000.0,88000000.0,6000000.0,-6000000.0,,,,-3000000.0,1000000.0,,0.0,,,,81000000.0,,101000000.0,98000000.0,,78000000.0,389000000.0,,,,,,,,,,,,,,,,,,,,,,7961000000.0,13265000000.0,1006000000.0,,,,,,,,,,,6299000000.0,,,,,,,,,6147000000.0,,,,0.0,,,,,,-118000000.0,-46000000.0,109000000.0,10000000.0,,,,,,,,,,,,,,,,,,,,,,,,,,,,,,82000000,,,,,415000000.0,,,,32000000.0,,,,,-53000000.0,,,,,,12000000.0,,,,,,,,,6000000.0,,,,,359000000.0,,,,,140000000.0,,,23000000.0,,2003000000.0,,,,,741000000.0,,,,51000000.0,,,,693000000.0,83000000.0,-47000000.0,,,11000000.0,,,,,147000000,,,,,,,,,,,0.0,,,,,,,,,,,,,,266000000.0,,,1969000000,,,,,,,,,,,,,,,0.0,,,,,,0.0,,,,,,,,27000000.0,,6554000000.0,,,,,,,,,,,,,,9000000.0,,,,,,,,,,,,,,,,,,,,,,,,,,,,,8801000000.0,5856000000.0,,,,,,,,,,,,,,,,,,,,,,,,,,,,,,,,,,540033000.0,537966000.0,,,,,,,,1
46,246000000,,,,,,,,,,530000000,,3477000000,,,-1393000000.0,4299000000.0,,,,,374000000.0,,,,13440000000.0,1611000000.0,,,,,,,,,,,,,,,,,,,,,,,,,,,,,,,,,,,,971000000.0,,,1999000000.0,,,,,0.15,1.25,,518735116.0,583548428.0,,,639000000.0,,,,,,,,,,1361000000.0,,,,,,,,,,,,,,,,,,,,,,,,,,,72000000.0,,,,,,,,,,,,,,,,,,,,,,,,,,,,,,,,,,,,,,,,,,,,,,,,,,,,,,,,,,,,,,,,,,,,,,,,,,,,,,,,,,,,,,,,,,,,,,,,,,,,,,,,,0.34,,,,,,,,,,,,,,,,,,,,,,,,,,,,,,,,,,,,,,,,,,,,,,-14000000.0,,23000000.0,,,,,,-14000000.0,,85000000.0,,,428000000.0,,,,,,,,,491000000.0,,,0.41,22000000.0,,,,,,,,,-16000000.0,,,98000000.0,,,,,,,,,,,,,,,,,,,,,,,,,,,,,,,3000000.0,,80000000.0,,,98000000.0,,76000000.0,,,,,,,,,,,,,,,,,,,,,,,7982000000.0,13009000000.0,1006000000.0,,,,,,,,,,,5974000000.0,,,,,,,,,6147000000.0,,,,,,,,,,,,,,,133000000.0,,,,,,,,,127000000.0,,,,,,,,,,,,,,,,,,,82000000,,,,,466000000.0,,0.0,,284000000.0,,,,,-52000000.0,,0.0,,,,,,,181000000.0,,,,,,28000000.0,,,,,358000000.0,,,,,,,,,-25000000.0,,,,,,,,,,,,,,693000000.0,,,,,,,,,,147000000,,,,,,,,,,,,,,,1000000.0,,,,,,,,,,,,,1969000000,,,,,,,,,,,,,,,0.0,,,7000000.0,,,,,,,,,,,,1445000000.0,,,,,,1610000000.0,,,,,27000000.0,,,,,,,,,,,,,,,,,,,,,,,,,,,,,,,,,8724000000.0,5304000000.0,,,,,,,,,,,,,,,,,,,,,,,,,,,,,,,,,,,,,,,,,,,1
47,246000000,,,,,,,,,,530000000,,3477000000,,,-1393000000.0,4163000000.0,,,,,372000000.0,33000000.0,,,13457000000.0,1611000000.0,,,,,,,,,,,,,,,,,,,,,,,,,,,,,,,,,,,,,676000000.0,73000000.0,,,,,,,1.25,,514121330.0,583548428.0,,,638000000.0,,,,,,,,,6103000000.0,1556000000.0,,,,,,,,,,,,,,,,,,18000000.0,,,,,,,,,147000000.0,,,,,,,,,,,,,,,,,,,,,,,,,,,,,,,,,,,,,,,,,,,,,,,,,,,,,,,,,,,,,479000000.0,,,,,,47000000.0,,,,,-23000000.0,,,,,,,,,,,,,,,,,,,,,,,,,,,1306000000.0,,,,,0.71,,0.71,,,,,,,,,,,,,,,,,,,,,,,,,,,,,,,,,,,,,,,,,,,,-27000000.0,,,,,,,,,,,79000000.0,,,375000000.0,,,,,,322000000.0,,,,,0.55,0.17,,,,,,,,15000000.0,,-3000000.0,,14000000.0,98000000.0,,,,,,,,,,,,,,,-97000000.0,,,,-14000000.0,54000000.0,20000000.0,-6000000.0,,,,0.0,48000000.0,,746000.0,,9000000.0,,258000000.0,2000000.0,153000000.0,98000000.0,,76000000.0,,,,,,,,,,,,,,,,,,,,,,,7958000000.0,12883000000.0,1006000000.0,,,,,,,,,,,5475000000.0,,,,,,,,,6147000000.0,,,,,,,,,,-219000000.0,-139000000.0,431000000.0,,,133000000.0,,,,,,,,,127000000.0,,,,,,,,,,,,,,,,,,,82000000,,,,,401000000.0,,0.0,,7000000.0,,,,,0.0,,,,,,-78000000.0,,,,,,,,,,,,,,370000000.0,,,,,65000000.0,,,36000000.0,,2003000000.0,,,,,995000000.0,,,,134000000.0,,,,693000000.0,99000000.0,-91000000.0,,,22000000.0,,,,,147000000,,,,,,,,,,,,,,,,,,,,,,,21000000.0,,157000000.0,,,1969000000,,,,,,,,,,,,,,,0.0,,,,,,,,,,,,,,8000000.0,1428000000.0,,,,,,1610000000.0,,,,,23000000.0,,,,20000000.0,,,,,,,,,,,,,,,,,,,,,,,,,,,,,8599000000.0,,,,,,,,,2730000.0,,,,,,,,,,,,,,,,,,,,,,,,,,540694000.0,538146000.0,,,,,,,,1
48,246000000,,,,,,,,,,530000000,,3477000000,,,,4089000000.0,,,,,,,,,13457000000.0,1611000000.0,,,,,,,,,,,,,,,,,,,,,,,,,,,,,,,,,,,,953000000.0,,,,,,,,,1.25,1360000000.0,511032862.0,,,,638000000.0,,179000000.0,,,,,,,,2860000000.0,,,,,,,,,,,,,,,,,,,,,,,,,,,,,,,,,,,,,,,,,,,,,,,,,,,,,,,,,,,,,,,,,,,,,,,,,,,,,,,,,,,,,,,,325000000.0,,,,,,,,,,,,,,,,,,,,,,,,,,,,,,,,,,,,,,,,,,,,0.99,,,,,,,,,,,,,,,,,,,,,,,,,,,,,,,,,,,,,,,,,,,,,,-2000000.0,,24000000.0,,,,,,-8000000.0,,170000000.0,,,840000000.0,,,,,,182000000.0,,,563000000.0,,,0.77,998000000.0,,,,,,,,,,,,98000000.0,,,,,,,,,,,,,,,,,,,,,,,,,,,,,,,5000000.0,,256000000.0,,,98000000.0,,,451000000.0,,,,,,,,,,,,,,,,,,,,,,7942000000.0,12820000000.0,1006000000.0,,,,,,,,,,,,,,,,,,,,6147000000.0,,,,,,,,,,,,,266000000.0,,,,,,,,,,,,,,,,,,,,,,,,,,,,,,82000000,,,,,401000000.0,,,,,,,,,,,1000000.0,,,,,,,49000000.0,,,,,,,,,,,370000000.0,,,,,,,,,-21000000.0,,,,,,,,,,,,,,693000000.0,,,,,,,,,,147000000,,,,,,,,,,,739000000.0,,,,5000000.0,,,,,,,,25000000.0,,157000000.0,,,1969000000,,,,,,,,,,,,,,,0.0,,,14000000.0,,,,,,,,,,,,1449000000.0,1548000000.0,,,,,,,,,,45000000.0,,,,,,,,,,,,,,,,,,,,,,,,,,,,,,,,,8177000000.0,5304000000.0,,,,,,,,,,,,,,,,,,,,,,,,,,,,,,,,,,,,,,,,,,,1
49,241000000,,,,,,,,,,448000000,,3460000000,,,-1379000000.0,4080000000.0,,,,,0.0,,,,13457000000.0,2493000000.0,,,,,,,,,,,,,,,,,,,,,,,,,,,,,,,,,,,,953000000.0,824000000.0,,,,,,,0.45,,1360000000.0,510483285.0,,,,638000000.0,,486000000.0,,,,,,,,1499000000.0,,,,,,,,,,,,,,,,,,,,,,,,,,,,,,,,,,,,,,,,,,,,,,,,,,,,,,,,,,,,,,,,,,,,,,,,,,,,,,,,,,,,,,,,142000000.0,,,,,,,,,,,,,,,,,,,,,,,,,,,,,,,,,,,,,,,,,,,0.26,-0.39,0.26,,,,,,,,,,,,,,,,,,,,,,,,,,,,,,,,,,,,,,,,,,,,-29000000.0,-15000000.0,,1000000.0,,,,,,-20000000.0,,94000000.0,,,465000000.0,,0.0,,,,185000000.0,,,194000000.0,,0.41,,966000000.0,,,,,,,,,429000000.0,,-13000000.0,24000000.0,,,,,,,,,,,,,,,,,,,,,,,,,,,,,,,2000000.0,,94000000.0,,,74000000.0,,76000000.0,393000000.0,,,,,,,,,,,,,,,,,,,,,,7601000000.0,12470000000.0,1816000000.0,,,,,,,,,,,,,,,,,,,,6299000000.0,,,,,,,,,,,,,157000000.0,,403000000.0,,,,,,,,,463000000.0,,,,,,,,,,,,,,,,,,,94000000,,,,,401000000.0,,,,,,,,,,,,,,,,,,79000000.0,,,,,,,,,,,370000000.0,,,,,,,,,,0.0,,,,,254000000.0,,,,,,,,669000000.0,22000000.0,,,,,,,,,141000000,,,,,,,,,,,739000000.0,,,,4000000.0,,,,,,,,34000000.0,,331000000.0,,,1911000000,,,,,,,,,,,,,,,,,,7000000.0,,,,,,,,,,,,1349000000.0,,,,,,4601000000.0,,,,,22000000.0,,,,,,,,,,,,,,,,,,,,,,,,,,,,,,,,,8177000000.0,5304000000.0,,,,,,,,,,,,,,,,,,,,,,,,,,,,,,,,,,,,,,,,,,,1
50,199000000,,,,,,,,,,525000000,,3493000000,,,-1323000000.0,4080000000.0,,,,,1000000.0,,,,13265000000.0,1651000000.0,,,,,,,,,,,,,,,,,,,,,,,,,,,,,,,,,,,,953000000.0,,745000000.0,1731000000.0,,,,,,,1360000000.0,510483285.0,584961444.0,,,,,508000000.0,,,,,,,3436000000.0,,,,,,,,,,,,,,,,,,,96000000.0,,,,,,,,,,,,,,,,,,,,,,,,,,,,,,,,,,,,,,,,,,,,,,,,,,,,,,,,,,,,,,,,,,,,,,,,,,,,,,,,,,,,,,,,,,,,,,,,,,,,,,,,,,,,1537000000.0,,,,,,,,,,,,,,,,,,,,,,,,,,,,,,,,,,,,,,,,,,,,,,,,,,,,,,,,,,,,20000000.0,,,,,,,16000000.0,,,,185000000.0,,,453000000.0,,0.17,,,,,,,,,55000000.0,,,,,48000000.0,,,,,,,,,,,,,,,-98000000.0,,,,5000000.0,66000000.0,49000000.0,-17000000.0,,,,-17000000.0,-29000000.0,,888000.0,,9000000.0,,371000000.0,5000000.0,319000000.0,97000000.0,,,416000000.0,,,,,,,,,,,,,,,,,,,,,,7851000000.0,12720000000.0,724000000.0,,,,,,,,,,,5053000000.0,,,,,,,,,6299000000.0,,,,,,,,,,-704000000.0,361000000.0,1088000000.0,157000000.0,,,,,,,,,,,,,,,,,,,,,,,,,,,,,,80000000,,,,,,,,,,,,,,,,1000000.0,,,,-97000000.0,,,,,,,,,,,,,,,,,,,23000000.0,,,61000000.0,-12000000.0,0.0,,,,,,,,,354000000.0,,,,652000000.0,,-152000000.0,,,22000000.0,,,,,131000000,,,,,,,,,,,739000000.0,,,,,,,,,,,,,,,,,1958000000,,,,,,,,,,,,,,,0.0,,,,,,,,,,,,,,10000000.0,1349000000.0,3359000000.0,,,,,,,,,,,,,,40000000.0,,,,,,,,,,,,,,,,,,,,,,,,,,,,,8177000000.0,,,,,,,,,,,,,,,,,,,,,,,,,,,,,,,,,,,542310000.0,539140000.0,,,,,,,,1
51,215000000,,,,,,,,,,617000000,,3423000000,,,-1313000000.0,4080000000.0,,,,,,,,,13603000000.0,2046000000.0,,,,,,,,,,,,,,,,,,,,,,,,,,,,,,,,,,,,,334000000.0,,1920000000.0,,,,,0.15,,,510483285.0,586697717.0,,,948000000.0,,318000000.0,,,,,,,1789000000.0,4364000000.0,,,,,,,,,,,,,,,,,,,,,,,,,,,,,,,,,,,,,,,,,,,,,,,,,,,,,,,,,,,,,,,,,,,,,,,,,,,,,,,,,,,,,,,,289000000.0,,,,,,,,,,,,,,,,,,,,,,,,,,,,,,,,,,,,,,,,,,,0.26,-0.22,0.26,,,,,,,,,,,,,,,,,,,,,,,,,,,,,,,,,,,,,,,,,,,,-21000000.0,-27000000.0,,25000000.0,,,,,,,,248000000.0,,,1251000000.0,,,,,,,,,,,0.77,,998000000.0,,,,,,,,,,,-25000000.0,48000000.0,,,,,,,,,,,,,,,,,,,,,50000000.0,,,,,,,,,,9000000.0,,369000000.0,,,86000000.0,,103000000.0,416000000.0,,,,,,,,,,,,,,,,,,,,,,7851000000.0,12720000000.0,832000000.0,,,,,,,,,,,,,,,,,,,,5974000000.0,,,,,,,,,,,,,,,180000000.0,,,,,,,,,100000000.0,,,,,,,,,,,,,,,,,,,103000000,,,,,407000000.0,,,,,,,,,,,,,,,,,,30000000.0,,,,,,,,,,,367000000.0,,,,,,,,,,0.0,,,,,507000000.0,,,,,,,,638000000.0,37000000.0,,,,,,,,,101000000,,,,,,,,,,,,,,,-34000000.0,,,,,,,,,,,,,1945000000,,,,,,,,,,,,,,,0.0,,,19000000.0,,,,,,,,,,,,1349000000.0,,,,,,1569000000.0,,,,,67000000.0,,,,,,,,,,,,,,,,,,,,,,,,,,,,,,,,,,5027000000.0,,,,,,,,,,,,,,,,,,,,,,,,,,,,,,,,,,,,,,,,,,,1
52,204000000,,,,,,,,,,596000000,,3432000000,,,-1212000000.0,,,,,,1000000.0,,,,13009000000.0,1609000000.0,,,,,,,,,,,,,,,,,,,,,,,,,,,,,,,,,,,,,,,1581000000.0,,,,,,,,,525484841.0,,,916000000.0,,329000000.0,,,,,,,5130000000.0,,,,,,,,,,,,,,,,,,,76000000.0,,,,,,,,,,,,,,,,,,,,,,,,,,,,,,,,,,,,,,,,,,,,,,,,,,,,,,,,,,,,,,,,,,,,,,,,,,,,,,,,,,,,,,,,,,,,,,,,,,,,,,,,,,,,,,,,,,,,,,,,,,,,,,,,,,,,,,,,,,,,,,,,,,,,,,,,,,,,,,,,,,,,,,,,-5000000.0,,253000000.0,,,,,,,,,181000000.0,,,269000000.0,,,,,,,,,,,10000000.0,,134000000.0,,,82000000.0,,,,,,,,,,,,,,,,,,,,,,0.0,,,,,,,0.0,,27000000.0,,,8000000.0,,87000000.0,,,416000000.0,,,,,,,,,,,,,,,,,,,,,,7851000000.0,12720000000.0,950000000.0,,,,,,,,,,,,,,,,,,,,5325000000.0,,,,,,,,,,-725000000.0,,1109000000.0,,,180000000.0,,,,,,,,,100000000.0,,,,,,,,,,,,,,,,,,,93000000,,,,,432000000.0,,,,,,,,,,,1000000.0,,,,,,,,,,,,,,,,,,363000000.0,,,,,201000000.0,,,,-12000000.0,,,,,,,,,,,,,,911000000.0,,,,,,,,,,139000000,,,,,,,,,,,739000000.0,,,,4000000.0,,,,,,,,4000000.0,,65000000.0,,,2013000000,,,,,,,,,,,,,,,0.0,,,,,,,,,,,,,,44000000.0,,1631000000.0,,,,,1569000000.0,,,,,,,,,,,,,,,,,,,,,,,,,,,,,,,,,,,,,,8082000000.0,4925000000.0,,,,,,,,,,,,,,,,,,,,,,,,,,,,,,,,,,,,,,,,,,,1
53,204000000,,,,,,,,,,596000000,,3432000000,,,-1212000000.0,9305000000.0,,,,,,,,,12883000000.0,1609000000.0,,,,,,,,,,,,,,,,,,,,,,,,,,,,,,,,,,,,,,-422000000.0,1581000000.0,,,,,,1.25,,759044221.0,524474315.0,,,935000000.0,,1445000000.0,,,,,,,1694000000.0,1504000000.0,,,,,,,,,,,,,,,,,,,,,,,,,,,,,,,,,,,,,,,,,,,,,,,,,,,,,,,,,,,,,,,,,,,,,,,,,,,,,,,,,,,,,,,,428000000.0,,,,,,,,,,,,,,,,,,,,,,,,,,,,,,,,,,,,,,,,,,,0.62,0.17,0.61,,,,,,,,,,,,,,,,,,,,,,,,,,,,,,,,,,,,,,,,,,,,8000000.0,,,1000000.0,,,,,,,,78000000.0,,,411000000.0,,147000000.0,,,,425000000.0,,,,,,,0.0,,,,,,,41000000.0,,,,-26000000.0,82000000.0,,,,,,,,,,,,,,,-91000000.0,,,,-10000000.0,57000000.0,11000000.0,0.0,,,,11000000.0,16000000.0,,,,4000000.0,,83000000.0,,114000000.0,87000000.0,,129000000.0,416000000.0,,,,,,,,,,,,,,,,,,,,,,11498000000.0,21779000000.0,950000000.0,,,,,,,,,,,,,,,,,,,,5325000000.0,,,,,,,,,,-380000000.0,-119000000.0,77000000.0,331000000.0,,,,,,,,,,,,,,,,,,,,,,,,,,,,,,93000000,,,,,543000000.0,,,,,,,,,,,,,,,41000000.0,,,102000000.0,,,,,,,,,,,360000000.0,,,,,,,,20000000.0,,0.0,,,,,760000000.0,,,,71000000.0,,,,911000000.0,59000000.0,10000000.0,,,0.0,,,,,139000000,,,,,,,,,,,,,,,15000000.0,,,,,,,,12000000.0,,,,,2013000000,,,,,,,,,,,,,,,0.0,,,5000000.0,,,,,,,,,,,,1177000000.0,,,,,,,,,,,22000000.0,,,,8000000.0,,,,,,,,,,,,,,,,,,,,,,,,,,,,,,4878000000.0,,,,,,,,,,,,,,,,,,,,,,,,,,,,,,,,,,550785000.0,545234000.0,,,,,,,,1
54,204000000,,,,,,,,,,596000000,,3432000000,,,-1212000000.0,8527000000.0,,,,,2000000.0,,,,12820000000.0,1609000000.0,,,,,,,,,,,,,,,,,,,,,,,,,,,,,,,,,,,,,,,797000000.0,,,,,,1.25,,733010052.0,524474315.0,,,936000000.0,,1478000000.0,,,,,,,6564000000.0,,,,,,,,,,,,,,,,,,,,,,,,,,,,,,,,,,,,,,,,,,,,,,,,,,,,,,,,,,,,,,,,,,,,,,,,,,,,,,,,,,,,,,,,,,,,,,,,,,,,,,,,,,,,,,,,,,,,,,,,,,,,,,,,,,,,,,,,,,,,,,,,,,,,,,,,,,,,,,,,,,,,,,,,,,,,,,,,,,,-29000000.0,,,,,,,,-13000000.0,,80000000.0,,,,,,,,,402000000.0,,,651000000.0,,,,,,,,,,,,,59000000.0,,,82000000.0,,,,,,,,,,,,,,,,,,,,,17000000.0,0.0,,,,,,,,,,,,,,87000000.0,,,,,,,,,,,,,,,,,,,,,,,,,12559000000.0,21989000000.0,950000000.0,,,,,,,,,,,,,,,,,,,,5325000000.0,,,,,,,,,,-390000000.0,,87000000.0,,,,,,,,,,,,,,,,,,,,,,,,,,,,,,,93000000,,,,,503000000.0,,,,,,,,,,,0.0,,,,,,,,,,,,,,,,,,346000000.0,,,,,148000000.0,,,,-13000000.0,,,,,,,,,,,,,,911000000.0,,,,,0.0,,,,,139000000,,,,,,,,,,,,,,,3000000.0,,,,,,,,48000000.0,,41000000.0,,,2013000000,,,,,,,,,,,,,,,,,,,,,,,,,,,,,,1106000000.0,5469000000.0,,,,,,,,,,,,,,,,,,,,,,,,,,,,,,,,,,,,,,,,,,,8202000000.0,4869000000.0,,,,,,,,,,,,,,,,,,,,,,,,,,,,,,,,,,,,,,,,,,,1
55,204000000,,,,,,,,,,596000000,,3432000000,,,-1212000000.0,8264000000.0,,,,,,,,,12486000000.0,1609000000.0,,,,,,,,,,,,,,,,,,,,,,,,,,,,,,,,,,,,,,-459000000.0,,,,,,0.6,1.25,1360000000.0,747932527.0,524474315.0,,,936000000.0,,959000000.0,,,,,,,1512000000.0,4183000000.0,,,,,,,,,,,,,,,,,,3000000.0,,,,,,,,,,,,,,,,,,,,,,,,,,,,,,,,,,,,,,,,,,,,,,,,,,,,,,,,,,,,,,,,,,,,,,512000000.0,,,,,,,,,,,,,,,,,,,,,,,,,,,,,,,,,,,,,,,,,,,0.35,-0.08,0.35,,,,,,,,,,,,,,,,,,,,,,,,,,,,,,,,,,,,,,,,,,,,-41000000.0,,,27000000.0,,,,,,,,332000000.0,,,1640000000.0,,154000000.0,,,,240000000.0,,,,,,,,,,,,,,83000000.0,,,,485000000.0,82000000.0,,,,,,,,,,,,,,,-25000000.0,,,,-35000000.0,15000000.0,16000000.0,0.0,,,,2000000.0,26000000.0,,621000.0,,36000000.0,,166000000.0,3000000.0,172000000.0,87000000.0,,,480000000.0,,,,,,,,,,,,,,,,,,,,,,11756000000.0,20946000000.0,950000000.0,,,,,,,,,,,,,,,,,,,,5325000000.0,,,,,,,,,,-691000000.0,-211000000.0,443000000.0,,,462000000.0,,,,,,,,,594000000.0,,,,,,,,,,,,,,,,,,,93000000,,,,,503000000.0,,,,,,,,,,,,,,,39000000.0,,,23000000.0,,,,,,,,,,,346000000.0,,,,,-15000000.0,,,34000000.0,,,,,,,1013000000.0,,,,170000000.0,,,,911000000.0,78000000.0,21000000.0,,,,,,,,139000000,,,,,,,,,,,732000000.0,,,,17000000.0,,,,,,,,61000000.0,,41000000.0,,,2013000000,,,,,,,,,,,,,,,,,,27000000.0,,,,,,,,,,,14000000.0,1101000000.0,,,,,,6216000000.0,,,,,89000000.0,,,,16000000.0,,,,,,,,,,,,,,,,,,,,,,,,,,,,,,4869000000.0,,,,,,,,,,,,,,,,,,,,,,,,,,,,,,,,,,554301000.0,549159000.0,,,,,,,,1
56,236000000,,,,,,,,,,549000000,,3487000000,,,,8282000000.0,,,,,13000000.0,,,,12720000000.0,2258000000.0,,,,,,,,,,,,,,,,,,,,,,,,,,,,,,,,,,,,,,-532000000.0,,,,,,,,1360000000.0,748528131.0,,,,936000000.0,,1119000000.0,,,,,,,,,,,,,,,,,,,,,,,,,,6000000.0,,,,,,,,,,,,,,,,,,,,,,,,,,,,,,,,,,,,,,,,,,,,,,,,,,,,,,,,,,,,,,,,,,,,,,,,,,,,,,,,,,,,,,,,,,,,,,,,,,,,,,,,,,,,,,,,,,0.13,,,,,,,,,,,,,,,,,,,,,,,,,,,,,,,,,,,,,,,,,,,,,-20000000.0,,,,,,,,,,,,,,1306000000.0,,1000000.0,,,,221000000.0,,,,,,,,,,,,,,42000000.0,,,,,7000000.0,,,,,,,,,,,,,,,-47000000.0,,,,-37000000.0,9000000.0,12000000.0,,,,,2000000.0,41000000.0,,355000.0,,,,83000000.0,5000000.0,290000000.0,84000000.0,,,411000000.0,,,,,,,,,,,,,,,,,,,,,,10063000000.0,19243000000.0,935000000.0,,,,,,,,,,,,,,,,,,,,5325000000.0,,,,,,,,,,-933000000.0,-324000000.0,725000000.0,,,,,,,,,,,,,,,,,,,,,,,,,,,,,,,93000000,,,,,503000000.0,,,,,,,,,,,,,,,-2000000.0,,,-247000000.0,,,,,,,,,,,346000000.0,,,,,0.0,,,45000000.0,0.0,0.0,,,,,,,,,276000000.0,,,,893000000.0,,32000000.0,,,,,,,,141000000,,,,,,,,,,,732000000.0,,,,22000000.0,,,,,,,,,,,,,1971000000,,,,,,,,,,,,,,,,,,20000000.0,,,,,,,,,,,14000000.0,1421000000.0,,,,,,,,,,,,,,,22000000.0,,,,,,,,,,,,,,,,,,,,,,,,,,,,,,4869000000.0,,,,,,,,,,,,,,,,,,,,,,,,,,,,,,,,,,557588000.0,552855000.0,,,,,,,,1
57,253000000,,,,,,,,,,775000000,,3550000000,,,-1163000000.0,8282000000.0,,,,,,,,,12720000000.0,3355000000.0,,,,,,,,,,,,,,,,,,,,,,,,,,,,,,,,,,,,861000000.0,,,,,,,,,,1360000000.0,748528131.0,524474000.0,,,,,,,,,,,,,1385000000.0,,,,,,,,,,,,,,,,,,,,,,,,,,,,,,,,,,,,,,,,,,,,,,,,,,,,,,,,,,,,,,,,,,,,,,,,,,,,,,,,,,,,,,,,133000000.0,,,,,,,,,,,,,,,,,,,,,,,,,,,,,,,,,,,,,,,,,,,,,,,,,,,,,,,,,,,,,,,,,,,,,,,,,,,,,,,,,,,,,,,,,,-41000000.0,,2000000.0,,,,,,-23000000.0,,87000000.0,,,336000000.0,,,,,,221000000.0,,,616000000.0,,,,,,,,,,,36000000.0,,,,59000000.0,7000000.0,,,,,,,,,,,,,,,,,,,,,32000000.0,,,,,,,,,,9000000.0,,,,,86000000.0,,,443000000.0,,,,,,,,,,,,,,,,,,,,,,10063000000.0,19243000000.0,1178000000.0,,,,,,,,,,,,,,,,,,,,5100000000.0,,,,,,,,,,-944000000.0,,736000000.0,41000000.0,,59000000.0,,,,,,,,,131000000.0,,,,,,,,,,,,,,,,,,,86000000,,,,,,,,,,,,,,,,1000000.0,,,,,,,,,,,,,,,,,,,,,,,-25000000.0,,,,3000000.0,273000000.0,,,,,254000000.0,,,,,,,,747000000.0,16000000.0,,,,0.0,,,,,141000000,,,,,,,,,,,,,,,2000000.0,,,,,,,,55000000.0,,125000000.0,,,1965000000,,,,,,,,,,,,,,,723000000.0,,,5000000.0,,,,,,,,,,,,1421000000.0,7532000000.0,,,,,1615000000.0,,,,,22000000.0,,,,,,,,,,,,,,,,,,,,,,,,,,,,,,,,,8731000000.0,,,,,,,,,,,,,,,,,,,,,,,,,,,,,,,,,,,,,,,,,,,,1
58,264000000,,,,,,,,,,1110000000,,3559000000,,,-1133000000.0,8282000000.0,,,,,13000000.0,,,,12720000000.0,3540000000.0,,,,,,,,,,,,,,,,,,,,,,,,,,,,,,,,,,,,,,-568000000.0,,,,,,,,,748528131.0,,,,939000000.0,,,,,,,,,,,,,,,,,,,,,,,,,,,,9000000.0,,,,,,,,,,,,,,,,,,,,,,,,,,,,,,,,,,,,,,,,,,,,,,,,,,,,,,,,,,,,,,,,,,,,,,,,,,,,,,,,,,,,,,,,,,,,,,,,,,,,,,,,,,,,,,,,,0.89,-0.1,0.88,,,,,,,,,,,,,,,,,,,,,,,,,,,,,,,,,,,,,,,,,,,,-47000000.0,,,,,,,,,,,,,,342000000.0,,,,,,628000000.0,,,828000000.0,,,,,,,,,,,119000000.0,,,,,72000000.0,,,,,,,,,,,,,,,-35000000.0,,,,-106000000.0,-10000000.0,30000000.0,,,,,-3000000.0,-17000000.0,,88000.0,,,,254000000.0,6000000.0,347000000.0,84000000.0,,,443000000.0,,,,,,,,,,,,,,,,,,,,,,10063000000.0,19243000000.0,1524000000.0,,,,,,,,,,,,,,,,,,,,5100000000.0,,,,,,,,,,-1145000000.0,-487000000.0,1064000000.0,41000000.0,,,,,,,,,,,,,,,,,,,,,,,,,,,,,,79000000,,,,,376000000.0,,,,,,,,,,,,,,,34000000.0,,,31000000.0,,,,,,,,,,,344000000.0,,,,,15000000.0,,,59000000.0,,,,,,,,,,,443000000.0,,,,711000000.0,,42000000.0,,,,,,,,146000000,,,,,,,,,,,732000000.0,,,,-9000000.0,,,,,,,,,,,,,1924000000,,,,,,,,,,,,,,,,,,,,,,,,,,,,,0.0,1421000000.0,,,,,,,,,,,,,,,31000000.0,,,,,,,,,,,,,,,,,,,,,,,,,,,,,8731000000.0,10281000000.0,,,,,,,,,,,,,,,,,,,,,,,,,,,,,,,,,,565383000.0,560505000.0,,,,,,,,1
59,281000000,,,,,,,,,,673000000,,3592000000,,,-1110000000.0,,,,,,,,,,,3135000000.0,,,,,,,,,,,,,,,,,,,,,,,,,,,,,,,,,,,,608000000.0,,,,,,,,0.15,,,,518735116.0,,,941000000.0,,115000000.0,,,,,,,,2050000000.0,,,,,,,,,,,,,,,,,,,,,,,,,,,,,,,,,,,,,,,,,,,,,,,,,,,,,,,,,,,,,,,,,,,,,,,,,,,,,,,,,,,,,,,,262000000.0,,,,,,,,,,,,,,,,,,,,,,,,,,,,,,,,,,,,,,,,,,,,,,,,,,,,,,,,,,,,,,,,,,,,,,,,,,,,,,,,,,,,,,,,,,-47000000.0,,6000000.0,,,,,,-10000000.0,,163000000.0,,,669000000.0,,,,,,572000000.0,,,,,,,,,,,,,,99000000.0,,,,106000000.0,24000000.0,,,,,,,,,,,,,,,,,,,,,52000000.0,,,,,,,,,,19000000.0,,,,,83000000.0,,,443000000.0,,,,,,,,,,,,,,,,,,,,,,,,954000000.0,,,,,,,,,,,,,,,,,,,,5099000000.0,,,,,,,,,,-1156000000.0,,1075000000.0,,,70000000.0,,,,,,,,,101000000.0,,,,,,,,,,,,,,,,,,,71000000,,,,,370000000.0,,,,,,,,,,,2000000.0,,,,,,,,,,,,,,,,,,340000000.0,,,,,4000000.0,,,,-42000000.0,366000000.0,,,,,254000000.0,,,,,,,,440000000.0,32000000.0,,,,0.0,,,,,205000000,,,,,,,,,,,,,,,,,,,,,,,81000000.0,,84000000.0,,,2057000000,,,,,,,,,,,,,,,723000000.0,,,11000000.0,,,,,,,,,,,,,,,,,,1494000000.0,,,,,44000000.0,,,,,,,,,,,,,,,,,,,,,,,,,,,,,,,,,8731000000.0,9430000000.0,,,,,,,,,,,,,,,,,,,,,,,,,,,,,,,,,,,,,,,,,,,1
60,281000000,,,,,,,,,,673000000,,3592000000,,,-1459000000.0,8340000000.0,,,,,14000000.0,,,,21989000000.0,3135000000.0,,,,,,,,,,,,,,,,,,,,,,,,,,,,,,,,,,,,,,,,,,,,0.15,1.25,,751410510.0,514121330.0,,,941000000.0,,,,,,,,,,2859000000.0,,,,,,,,,,,,,,,,,,42000000.0,,,,,,,,,,,,,,,,,,,,,,,,,,,,,,,,,,,,,,,,,,,,,,,,,,,,,,,,,,,,,,,,,,,,,,,,,,,,,,,,,,,,,,,,,,,,,,,,,,,,,,,,,,,,,,,,,0.27,,0.27,,,,,,,,,,,,,,,,,,,,,,,,,,,,,,,,,,,,,,,,,,,,,,,,,,,,,,,,,,575000000.0,,,,,,203000000.0,,,101000000.0,,,,,,,,,,,36000000.0,,,,,24000000.0,,,,,,,,,,,,,,,,,,,,,,,,,,,,,721000.0,,,,88000000.0,9000000.0,,83000000.0,,,443000000.0,,,,,,,,,,,,,,,,,,,,,,9786000000.0,19001000000.0,954000000.0,,,,,,,,,,,,,,,,,,,,5099000000.0,,,,,,,,,,,,,125000000.0,,70000000.0,,,,,,,,,101000000.0,,,,,,,,,,,,,,,,,,,71000000,,,,,364000000.0,,,,,,,,,,,,,,,-5000000.0,,,80000000.0,,,,,,,,,,,339000000.0,,,,,-21000000.0,,,,,,,,,,,,,,,,,,440000000.0,,,,,,,,,,205000000,,,,,,,,,,,732000000.0,,,,-7000000.0,,,,,,,,,,,,,2057000000,,,,,,,,,,,,,,,,,,8000000.0,,,,,,,,,,,16000000.0,1364000000.0,2506000000.0,,,,,1494000000.0,,,,,,,,,,,,,,,,,,,,,,,,,,,,,,,,,,,,,,8731000000.0,9190000000.0,,,,,,,,,,,,,,,,,,,,,,,,,,,,,,,,,,587179000.0,582828000.0,,,,,,,,1
61,281000000,,,,,,,,,,673000000,,3592000000,,,-1459000000.0,8374000000.0,,,,,,,,,20946000000.0,3135000000.0,,,,,,,,,,,,,,,,,,,,,,,,,,,,,,,,,,,,898000000.0,,-597000000.0,,,,,,,1.25,,752711155.0,511032862.0,,,944000000.0,,315000000.0,,,,,,,,1057000000.0,,,,,,,,,,,,,,,,,,,,,,,,,,,,,,,,,,,,,,,,,,,,,,,,,,,,,,,,,,,,,,,,,,,,,,,,,,,,,,,,,,,,,,,,394000000.0,,,,,,,,,,,,,,,,,,,,,,,,,,,,,,,,,,,,,,,,,,,0.27,0.2,0.27,,,,,,,,,,,,,,,,,,,,,,,,,,,,,,,,,,,,,,,,,,,,13000000.0,,,4000000.0,,,,,,35000000.0,,76000000.0,,,333000000.0,,,,,,203000000.0,,,193000000.0,,,,,,,,,,,24000000.0,,,,129000000.0,24000000.0,,,,,,,,,,,,,,,-70000000.0,,,,36000000.0,43000000.0,19000000.0,,,,,1000000.0,47000000.0,,,,10000000.0,,,,125000000.0,83000000.0,,,,,,,,,,,,,,,,,,,,,,,,,9900000000.0,18990000000.0,954000000.0,,,,,,,,,,,,,,,,,,,,5099000000.0,,,,,,,,,,-668000000.0,24000000.0,47000000.0,,,,,,,,,,,,,,,,,,,,,,,,,,,,,,,71000000,,,,,375000000.0,,,,,,,,,,,,,,,,,,,,,,,,,,,,,340000000.0,,,,,-56000000.0,,,18000000.0,-3000000.0,,,,,,254000000.0,,,,57000000.0,,,,440000000.0,355000000.0,4000000.0,,,,,,,,205000000,,,,,,,,,,,,,,,-11000000.0,,,,,,,,89000000.0,,242000000.0,,,2057000000,,,,,,,,,,,,,,,2423000000.0,,,6000000.0,,,,,,,,,,,,1154000000.0,,,,,,,,,,,22000000.0,,,,24000000.0,,,,,,,,,,,,,,,,,,,,,,,,,,,,,,9180000000.0,,,,,,,,,,,,,,,,,,,,,,,,,,,,,,,,,,,,,,,,,,,1
62,281000000,,,,,,,,,,673000000,,3592000000,,,-1459000000.0,8391000000.0,,,,,15000000.0,,,,19243000000.0,3135000000.0,,,,,,,,,,,,,,,,,,,,,,,,,,,,,,,,,,,,898000000.0,,,,,,,,,1.25,1360000000.0,753050533.0,510483285.0,,,944000000.0,,,,,,,,,,1474000000.0,,,,,,,,,,,,,,,,,,,,,,,,,,,,,,,,,,,,,,,,,,,,,,,,,,,,,,,,,,,,,,,,,,,,,,,,,,,,,,,,,,,,,,,,,,,,,,,,,,,,,,,,,,,,,,,,,,,,,,,,,,,,,,,,,,,,,,,,,,,,,,,,,,,,,,,,,,,,,,,,,,,,,,,,,,,,,,,,,,13000000.0,,,,,,,,-35000000.0,,,,,288000000.0,,,,,,170000000.0,,,245000000.0,,,,,,,,,,,-129000000.0,,,,,24000000.0,,,,,,,,,,,,,,,,,,,,,,,,,,,,,1454000.0,,,,344000000.0,,,83000000.0,,,505000000.0,,,,,,,,,,,,,,,,,,,,,,9357000000.0,18402000000.0,954000000.0,,,,,,,,,,,,,,,,,,,,5099000000.0,,,,,,,,,,,,,84000000.0,,,,,,,,,,,,,,,,,,,,,,,,,,,,,,71000000,,,,,375000000.0,,,,,,,,,,,0.0,,,,25000000.0,,,49000000.0,,,,,,,,,,,340000000.0,,,,,,,,,,60000000.0,,,,,,,,,,,,,440000000.0,,,,,,,,,,205000000,,,,,,,,,,,,,,,1000000.0,,,,,,,,,,,,,2057000000,,,,,,,,,,,,,,,,,,5000000.0,,,,,,,,,,,2000000.0,1050000000.0,5650000000.0,,,,,,,,,,,,,,,,,,,,,,,,,,,,,,,,,,,,,,,,,,,,9180000000.0,,,,,,,,,,,,,,,,,,,,,,,,,,,,,,,,,,571239000.0,566329000.0,,,,,,,,1
63,310000000,,,,,,,,,,674000000,,3654000000,,,,8439000000.0,,,,,,,,,19243000000.0,2775000000.0,,,,,,,,,,,,,,,,,,,,,,,,,,,,,,,,,,,,898000000.0,,,,,,,,,,1360000000.0,755222727.0,510483285.0,,,944000000.0,,,,,,,,,,4304000000.0,,,,,,,,,,,,,,,,,,,,,,,,,,,,,,,,,,,,,,,,,,,,,,,,,,,,,,,,,,,,,,,,,,,,,,,,,,,,,,,,,,,,,,,,,,,,,,,,,,,,,,,,,,,,,,,,,,,,,,,,,,,,,,,,,,,0.95,,0.95,,,,,,,,,,,,,,,,,,,,,,,,,,,,,,,,,,,,,,,,,,,,,12000000.0,,,,,,,,-25000000.0,,,,,857000000.0,,,,,,434000000.0,,,144000000.0,,,,,,,,,,,,,,,,8000000.0,,,,,,,,,,,,,,,,,,,,,,,,,,,,,968000.0,,,,338000000.0,,,72000000.0,,,499000000.0,,,,,,,,,,,,,,,,,,,,,,9160000000.0,18059000000.0,984000000.0,,,,,,,,,,,,,,,,,,,,5053000000.0,,,,,,,,,,,,,,,,,,,,,,,,,,,,,,,,,,,,,,,,,,,92000000,,,,,,,,,,,,,,,,,,,,,,,122000000.0,,,,,,,,,,,,,,,,-18000000.0,,,,1000000.0,60000000.0,,,,,,,,,,,,,432000000.0,,,,,,,,,,206000000,,,,,,,,,,,,,,,40000000.0,,,,,,,,,,,,,2026000000,,,,,,,,,,,,,,,0.0,,,12000000.0,,,,,,,,,,,25000000.0,1078000000.0,3144000000.0,,,,,,,,,,,,,,,,,,,,,,,,,,,,,,,,,,,,,,,,,,,,9180000000.0,,,,,,,,,,,,,,,,,,,,,,,,,,,,,,,,,,,,,,,,,,,1
64,283000000,,,,,,,,,,658000000,,3673000000,,,,8439000000.0,,,,,0.0,,,,19243000000.0,3012000000.0,,,,,,,,,,,,,,,,,,,,,,,,,,,,,,,,,,,,,,-233000000.0,,,,,,0.15,,1360000000.0,755222727.0,510483285.0,,,,,516000000.0,,,,,,,,1073000000.0,,,,,,,,,,,,,,,,,,25000000.0,,,,,,,,,,,,,,,,,,,,,,,,,,,,,,,,,,,,,,,,,,,,,,,,,,,,,,,,,,,,,,,,,,,,,,,,,,,,,,,,,,,,,,,,,,,,,,,,,,,,,,,,,,,,,,,,,,0.1,,,,,,,,,,,,,,,,,,,,,,,,,,,,,,,,,,,,,,,,,,,,,-1000000.0,,,1000000.0,,,,,,,,75000000.0,,,375000000.0,,,,,,320000000.0,,,325000000.0,,,,,,,,,,,56000000.0,,,,,6000000.0,,,,,,,,,,,,,,,61000000.0,,,,116000000.0,-49000000.0,64000000.0,,,,,3000000.0,96000000.0,,,,15000000.0,,83000000.0,6000000.0,367000000.0,68000000.0,,,520000000.0,,,,,,,,,,,,,,,,,,,,,,9160000000.0,18059000000.0,941000000.0,,,,,,,,,,,,,,,,,,,,5053000000.0,,,,,,,,,,-1710000000.0,591000000.0,886000000.0,242000000.0,,157000000.0,,,,,,,,,176000000.0,,,,,,,,,,,,,,,,,,,62000000,,,,,,,,,,,,,,,,0.0,,,,2000000.0,,,,,,,,,,,,,,,,,,,-52000000.0,,,42000000.0,,,,,,,,,,,260000000.0,,,,347000000.0,,5000000.0,,,,,,,,165000000,,,,,,,,,,,0.0,,,,-8000000.0,,,,,,,,,,384000000.0,,,2000000000,,,,,,,,,,,,,,,,,,6000000.0,,,,,,,,,,,39000000.0,1078000000.0,,,,,,1793000000.0,,,,,22000000.0,,,,53000000.0,,,,,,,,,,,,,,,,,,,,,,,,,,,,,10400000000.0,,,,,,,,,,,,,,,,,,,,,,,,,,,,,,,,,,,589312000.0,584915000.0,,,,,,,,1
65,272000000,,,,,,,,,,664000000,,3680000000,,,-1428000000.0,8439000000.0,,,,,15000000.0,,,,,3048000000.0,,,,,,,,,,,,,,,,,,,,,,,,,,,,,,,,,,,,,,,,,,,,,,,755222727.0,510483000.0,,,946000000.0,,,,,,,,,,1445000000.0,,,,,,,,,,,,,,,,,,,,,,,,,,,,,,,,,,,,,,,,,,,,,,,,,,,,,,,,,,,,,,,,,,,,,,,,,,,,,,,,,,,,,,,,120000000.0,,,,,,,,,,,,,,,,,,,,,,,,,,,,,,,,,,,,,,,,,,,,,,,,,,,,,,,,,,,,,,,,,,,,,,,,,,,,,,,,,,,,,,,,,,11000000.0,,,,,,,,-34000000.0,,,,,282000000.0,,,,,,,,,436000000.0,,,,,,,,,,,50000000.0,,,,17000000.0,15000000.0,,,,,,,,,,,,,,,,,,,,,,,,,,,,,,,,,,,,72000000.0,,,520000000.0,,,,,,,,,,,,,,,,,,,,,,9160000000.0,18059000000.0,1054000000.0,,,,,,,,,,,,,,,,,,,,4935000000.0,,,,,,,,,,,,,,,157000000.0,,,,,,,,,176000000.0,,,,,,,,,,,,,,,,,,,67000000,,,,,,,,,,,,,,,,,,,,,,,42000000.0,,,,,,,,,,,,,,,,-41000000.0,,,,-21000000.0,60000000.0,,,,,127000000.0,,,,,,,,335000000.0,14000000.0,,,,,,,,,146000000,,,,,,,,,,,,,,,-9000000.0,,,,,,,,25000000.0,,,,,1997000000,,,,,,,,,,,,,,,0.0,,,4000000.0,,,,,,,,,,,,1078000000.0,7995000000.0,,,,,1793000000.0,,,,,,,,,,,,,,,,,,,,,,,,,,,,,,,,,,,,,,,9215000000.0,,,,,,,,,,,,,,,,,,,,,,,,,,,,,,,,,,,,,,,,,,,1
66,247000000,,,,,,,,,,511000000,,3710000000,,,-1379000000.0,,,,,,,,,,19001000000.0,2746000000.0,,,,,,,,,,,,,,,,,,,,,,,,,,,,,,,,,,,,639000000.0,,-336000000.0,,,,,,,,,,,,,947000000.0,,201000000.0,,,,,,,,4153000000.0,,,,,,,,,,,,,,,,,,111000000.0,,,,,,,,,,,,,,,,,,,,,,,,,,,,,,,,,,,,,,,,,,,,,,,,,,,,,,,,,,,,,,,,,,,,,,,,,,,,,,,,,,,,,,,,,,,,,,,,,,,,,,,,,,,,,,,,,0.07,0.68,0.07,,,,,,,,,,,,,,,,,,,,,,,,,,,,,,,,,,,,,,,,,,,,11000000.0,,,12000000.0,,,,,,,,310000000.0,,,1388000000.0,,,,,,-194000000.0,,,132000000.0,,,,,,,,,,,109000000.0,,,,,42000000.0,,,,,,,,,,,,,,,11000000.0,,,,50000000.0,-61000000.0,68000000.0,,,,,-5000000.0,54000000.0,,1306000.0,,43000000.0,,171000000.0,8000000.0,446000000.0,69000000.0,,,520000000.0,,,,,,,,,,,,,,,,,,,,,,,,1740000000.0,,,,,,,,,,,,,,,,,,,,4071000000.0,,,,,,,,,,-3630000000.0,2559000000.0,735000000.0,117000000.0,,,,,,,,,,,,,,,,,,,,,,,,,,,,,,64000000,,,,,,,,,,,,,,,,0.0,,,,11000000.0,,,,,,,,,,,,,,,,,,,61000000.0,,,57000000.0,-44000000.0,,,,,,,,,,451000000.0,,,,344000000.0,,5000000.0,,,,,,,,216000000,,,,,,,,,,,0.0,,,,,,,,,,,,,,,,,2171000000,,,,,,,,,,,,,,,,,,24000000.0,,,,,,,,,,,117000000.0,,,,,,,,,,,,87000000.0,,,,60000000.0,,,,,,,,,,,,,,,,,,,,,,,,,,,,,10369000000.0,9090000000.0,,,,,,,,,,,,,,,,,,,,,,,,,,,,,,,,,,589542000.0,585491000.0,,,,,,,,1
67,247000000,,,,,,,,,,511000000,,3710000000,,,-1337000000.0,8466000000.0,,,,,23000000.0,,,,18990000000.0,2746000000.0,,,,,,,,,,,,,,,,,,,,,,,,,,,,,,,,,,,,,,,,,,,,,1.25,,756699978.0,,,,936000000.0,,,,,,,,,,4121000000.0,,,,,,,,,,,,,,,,,,,,,,,,,,,,,,,,,,,,,,,,,,,,,,,,,,,,,,,,,,,,,,,,,,,,,,,,,,,,,,,,,,,,,,,,239000000.0,,,,,,,,,,,,,,,,,,,,,,,,,,,,,,,,,,,,,,,,,,,,,,,,,,,,,,,,,,,,,,,,,,,,,,,,,,,,,,,,,,,,,,,,,,5000000.0,,,,,,,,-9000000.0,,,,,1125000000.0,,,,,,-252000000.0,,,191000000.0,,,,,,,,,,,,,,,58000000.0,42000000.0,,,,,,,,,,,,,,,,,,,,,,,,,,,,,,,,,167000000.0,,,69000000.0,,,520000000.0,,,,,,,,,,,,,,,,,,,,,,8894000000.0,17885000000.0,1740000000.0,,,,,,,,,,,,,,,,,,,,4071000000.0,,,,,,,,,,,,,117000000.0,,,,,,,,,,,,,,,,,,,,,,,,,,,,,,64000000,,,,,,,,,,,,,,,,,,,,,,,-103000000.0,,,,,,,,,,,,,,,,55000000.0,,,,-5000000.0,60000000.0,,,,,255000000.0,,,,,,,,344000000.0,27000000.0,,,,,,,,,216000000,,,,,,,,,,,,,,,,,,,,,,,48000000.0,,142000000.0,,,2171000000,,,,,,,,,,,,,,,831000000.0,,,18000000.0,,,,,,,,,,,111000000.0,1365000000.0,2345000000.0,,,,,,,,,,,,,,,,,,,,,,,,,,,,,,,,,,,,,,,,,,,,9045000000.0,,,,,,,,,,,,,,,,,,,,,,,,,,,,,,,,,,,,,,,,,,,1
68,266000000,,,,,,,,,,403000000,,3759000000,,,-1562000000.0,8496000000.0,,,,,,,,,18402000000.0,2053000000.0,,,,,,,,,,,,,,,,,,,,,,,,,,,,,,,,,,,,2362000000.0,,,,,,,,0.45,1.25,,757646433.0,759044221.0,,,933000000.0,,687000000.0,,,,,,,,5694000000.0,,,,,,,,,,,,,,,,,,72000000.0,,,,,,,,,,,,,,,,,,,,,,,,,,,,,,,,,,,,,,,,,,,,,,,,,,,,,,,,,,,,,,,,,,,,,,,,,,,,,,,,,,,,,,,,,,,,,,,,,,,,,,,,,,,,,,,,,0.31,0.38,0.31,,,,,,,,,,,,,,,,,,,,,,,,,,,,,,,,,,,,,,,,,,,,-1000000.0,,,,,,,,,,,,,,1093000000.0,,,,,,250000000.0,,,411000000.0,,,,,,,,,,,59000000.0,,,,,28000000.0,,,,,,,,,,,,,,,,,,,-5000000.0,,77000000.0,,,,,,,,1344000.0,,65000000.0,,88000000.0,9000000.0,,72000000.0,,,,,,,,,,,,,,,,,,,,,,,,,8767000000.0,18048000000.0,1650000000.0,,,,,,,,,,,,,,,,,,,,4072000000.0,,,,,,,,,,,,,,,454000000.0,,,,,,,,,479000000.0,,,,,,,,,,,,,,,,,,,56000000,,,,,,,,,,,,,,,,0.0,,,,9000000.0,,,,,,,,,,,,,,,,,,,47000000.0,,,,-28000000.0,,,,,,,,,,,,,,346000000.0,,,,,,,,,,202000000,,,,,,,,,,,0.0,,,,-10000000.0,,,,,,,,,,,,,2157000000,,,,,,,,,,,,,,,,,,,,,,,,,,,,,125000000.0,1441000000.0,,,,,,5059000000.0,,,,,,,,,,,,,,,,,,,,,,,,,,,,,,,,,,,,,,10767000000.0,8899000000.0,,,,,,,,,,,,,,,,,,,,,,,,,,,,,,,,,,589766000.0,586061000.0,,,,,,,,1
